,word,likes,retweets,comments,n,avg_likes,avg_retweets,avg_comments,trafic
1,vej,3430,452,,87,39,5,,3882
2,miljøministerium,47,13,,1,47,13,,60
3,biodiversitetsmål,47,13,,1,47,13,,60
4,Danmark,12567,1730,,237,53,7,,14297
5,beskytte,680,63,,5,136,13,,743
6,natur,779,133,,33,24,4,,912
7,land,3218,444,,93,35,5,,3662
8,hav,713,68,,9,79,8,,781
9,dkgreen,5484,940,,154,36,6,,6424
10,https://t.co/auA5QnEVkV,47,13,,1,47,13,,60
11,nettofordel,1,0,,2,0,0,,1
12,klima,2973,307,,54,55,6,,3280
13,boring,28,16,,3,9,5,,44
14,Nordsøen,26,9,,5,5,2,,35
15,reserve,149,32,,3,50,11,,181
16,jord,299,21,,13,23,2,,320
17,signal,181,42,,7,26,6,,223
18,plan,673,145,,32,21,5,,818
19,klimaafgifter,1,0,,2,0,0,,1
20,Klimaet,831,99,,7,119,14,,930
21,tid,4663,484,,116,40,4,,5147
22,Løkke,935,190,,41,23,5,,1125
23,KL-topmøde,17,15,,2,8,8,,32
24,milliard,1048,222,,28,37,8,,1270
25,kommune,1874,313,,60,31,5,,2187
26,dkpol,78083,11466,,1788,44,6,,89549
27,KLtop16,17,15,,2,8,8,,32
28,https://t.co/zm916cxQeH,14,13,,1,14,13,,27
29,alternativ,30,9,,4,8,2,,39
30,Alternativet,847,151,,32,26,5,,998
31,LMÅ17,50,10,,2,25,5,,60
32,indsats,1919,243,,35,55,7,,2162
33,unge,2255,349,,84,27,4,,2604
34,legalisering,33,6,,5,7,1,,39
35,allevegne,1,0,,1,1,0,,1
36,Tyskland,235,59,,10,24,6,,294
37,regering,8848,1227,,229,39,5,,10075
38,lov,2498,369,,69,36,5,,2867
39,forsøg,345,77,,14,25,6,,422
40,Borgerløn,143,42,,5,29,8,,185
41,ide,439,60,,23,19,3,,499
42,DK?@alternativet,37,13,,1,37,13,,50
43,puls,6,5,,1,6,5,,11
44,terminal,6,5,,1,6,5,,11
45,patient,505,100,,17,30,6,,605
46,resurseforløb,47,23,,7,7,3,,70
47,bilbranche,5,2,,1,5,2,,7
48,Ekkodalen,5,2,,1,5,2,,7
49,Kondolerer,3,0,,1,3,0,,3
50,ord,2602,263,,50,52,5,,2865
51,rollemodel,3,0,,1,3,0,,3
52,borgerlig,2528,188,,34,74,6,,2716
53,fattigdomsgrænse,301,42,,8,38,5,,343
54,liv,1721,199,,47,37,4,,1920
55,Darth,1,0,,1,1,0,,1
56,reduktionsmål,678,59,,3,226,20,,737
57,hele,2803,286,,91,31,3,,3089
58,klimaDanmark,3,0,,1,3,0,,3
59,fagforening,26,5,,5,5,1,,31
60,skræmme,893,74,,8,112,9,,967
61,retræte,3,0,,1,3,0,,3
62,nøgen,5,1,,1,5,1,,6
63,I-Phone,5,1,,1,5,1,,6
64,vigtig,4018,533,,114,35,5,,4551
65,hovedfokus,46,12,,1,46,12,,58
66,Mogens,669,51,,9,74,6,,720
67,mink,1165,98,,13,90,8,,1263
68,dkool,46,12,,1,46,12,,58
69,DAGE,2,2,,2,1,1,,4
70,DEMO,2,2,,2,1,1,,4
71,studere,810,60,,18,45,3,,870
72,udd,5,5,,2,2,2,,10
73,time,940,89,,27,35,3,,1029
74,feedback,15,3,,2,8,2,,18
75,vejledning,239,35,,8,30,4,,274
76,https://t.co/D70bD4BbDi,2,2,,1,2,2,,4
77,uddpol,810,121,,26,31,5,,931
78,tvangsanbringelse,67,14,,3,22,5,,81
79,intensiv,10,3,,1,10,3,,13
80,terapeutisk,10,3,,1,10,3,,13
81,familiebehandling,10,3,,1,10,3,,13
82,dyr,483,108,,18,27,6,,591
83,familie,1802,270,,45,40,6,,2072
84,barn,8933,1020,,164,54,6,,9953
85,Vibygård,10,3,,1,10,3,,13
86,Høring,29,11,,4,7,3,,40
87,anbringelse,159,21,,4,40,5,,180
88,Borgen,317,86,,23,14,4,,403
89,dksocial,749,258,,48,16,5,,1007
90,Sej,4,0,,1,4,0,,4
91,knægt,4,0,,1,4,0,,4
92,stolt,1453,113,,19,76,6,,1566
93,enig,2417,229,,102,24,2,,2646
94,udvalg,130,19,,3,43,6,,149
95,handling,555,87,,25,22,3,,642
96,total,83,23,,8,10,3,,106
97,kulegravning,50,10,,3,17,3,,60
98,økonomi,977,102,,29,34,4,,1079
99,aktivitet,115,25,,6,19,4,,140
100,hjemløseområdet,25,7,,1,25,7,,32
101,mangen,4399,573,,163,27,4,,4972
102,hundrede,34,10,,3,11,3,,44
103,million,950,155,,24,40,6,,1105
104,krone,735,162,,23,32,7,,897
105,område,1056,136,,48,22,3,,1192
106,antal,129,24,,11,12,2,,153
107,hjemløs,134,28,,8,17,4,,162
108,https://t.co/1uW7QrbToZ,25,7,,1,25,7,,32
109,Johhh,0,0,,1,0,0,,0
110,stringent,0,0,,1,0,0,,0
111,fattig,1189,179,,26,46,7,,1368
112,gang,4595,649,,139,33,5,,5244
113,ifbm,4,2,,2,2,1,,6
114,sundhed,432,111,,21,21,5,,543
115,fattigdom,417,56,,18,23,3,,473
116,forvaltning,65,17,,5,13,3,,82
117,afgørelsespolitik,1,1,,1,1,1,,2
118,Retorisk,1,1,,1,1,1,,2
119,Advokatrådets,4,3,,4,1,1,,7
120,debat,1770,194,,79,22,2,,1964
121,retssikkerhed,346,44,,8,43,6,,390
122,Tak,6463,750,,194,33,4,,7213
123,historisk,146,26,,6,24,4,,172
124,modstand,444,68,,8,56,8,,512
125,førtidspensionsref,46,12,,1,46,12,,58
126,udsætte,823,174,,32,26,5,,997
127,gade,241,53,,13,19,4,,294
128,dagsorden,665,82,,13,51,6,,747
129,Dkpol,20,6,,2,10,3,,26
130,dkklima,596,109,,12,50,9,,705
131,fred,243,18,,6,40,3,,261
132,Bethlehem,15,5,,1,15,5,,20
133,Palæstina,15,5,,1,15,5,,20
134,Mellemøsten,627,43,,4,157,11,,670
135,righttomovement,15,5,,1,15,5,,20
136,https://t.co/V3VBuZuAGQ,15,5,,1,15,5,,20
137,mil,32,17,,1,32,17,,49
138,Satsmidlerne,32,17,,1,32,17,,49
139,borgerstyrede,32,17,,1,32,17,,49
140,budgettere,32,17,,1,32,17,,49
141,dansker,6516,1010,,106,61,10,,7526
142,https://t.co/BlF45nKU57,32,17,,1,32,17,,49
143,Alternativets,303,58,,13,23,4,,361
144,tillidsparlament,6,2,,1,6,2,,8
145,Christiansborg,379,79,,23,16,3,,458
146,Dejligt,214,47,,15,14,3,,261
147,fremmøde,46,11,,3,15,4,,57
148,tillid,679,93,,23,30,4,,772
149,Regering,12,14,,4,3,4,,26
150,sandhed,184,55,,10,18,6,,239
151,krav,1757,253,,40,44,6,,2010
152,timer,197,62,,10,20,6,,259
153,arbejde,2757,392,,83,33,5,,3149
154,kontanthjælpsloftet,11,5,,4,3,1,,16
155,mindsteløn,4,2,,1,4,2,,6
156,Syge,34,18,,1,34,18,,52
157,ledig,363,90,,14,26,6,,453
158,job,745,153,,45,17,3,,898
159,ordning,273,56,,14,20,4,,329
160,rask,40,22,,4,10,6,,62
161,tigge,332,33,,3,111,11,,365
162,samfund,3571,431,,67,53,6,,4002
163,utilstrækkelig,86,16,,2,43,8,,102
164,hjælp,1036,178,,24,43,7,,1214
165,lovgivning,269,68,,15,18,5,,337
166,folk,2936,325,,76,39,4,,3261
167,fængsel,193,32,,9,21,4,,225
168,tiggeri,84,15,,1,84,15,,99
169,https://t.co/Qesx3kN08,84,15,,1,84,15,,99
170,Jobreform,5,4,,2,2,2,,9
171,Thorkild,3,0,,2,2,0,,3
172,udspil,124,48,,13,10,4,,172
173,valg,3793,390,,94,40,4,,4183
174,sal,415,65,,12,35,5,,480
175,realitet,8,2,,3,3,1,,10
176,Roser,4,1,,1,4,1,,5
177,gode,2911,274,,83,35,3,,3185
178,arbejdsløs,604,51,,12,50,4,,655
179,statistik,8,4,,4,2,1,,12
180,Kære,1402,83,,24,58,3,,1485
181,Folketingets,1019,112,,15,68,7,,1131
182,talerstol,448,66,,13,34,5,,514
183,lod,22,6,,3,7,2,,28
184,mål,946,128,,40,24,3,,1074
185,begrænsning,32,9,,3,11,3,,41
186,CO2,651,108,,20,33,5,,759
187,Venstre,2581,314,,47,55,7,,2895
188,INDTIL,22,5,,1,22,5,,27
189,Venstres,170,17,,7,24,2,,187
190,politik,3011,302,,79,38,4,,3313
191,græsse,34,6,,2,17,3,,40
192,høne,7,2,,1,7,2,,9
193,Bæredygtighedsfestival,7,2,,1,7,2,,9
194,Aalborg,104,44,,14,7,3,,148
195,venligrevolution,212,77,,10,21,8,,289
196,gokgok,7,2,,1,7,2,,9
197,https://t.co/rzmS0xcg5z,7,2,,1,7,2,,9
198,Glad,141,26,,7,20,4,,167
199,støtte,1024,153,,38,27,4,,1177
200,frivillig,154,32,,8,19,4,,186
201,social,1299,170,,38,34,4,,1469
202,organisation,283,44,,12,24,4,,327
203,dyst,77,18,,2,38,9,,95
204,baggrund,491,93,,17,29,5,,584
205,psykiatribrugere,60,16,,1,60,16,,76
206,menneske,3947,489,,92,43,5,,4436
207,handicappe,479,96,,19,25,5,,575
208,Coronakrisen,315,58,,6,52,10,,373
209,model,142,35,,21,7,2,,177
210,lønindkomst,2,0,,1,2,0,,2
211,borgerlønnen,6,0,,3,2,0,,6
212,skatte,1401,171,,50,28,3,,1572
213,afgift,957,114,,37,26,3,,1071
214,måde,1598,108,,59,27,2,,1706
215,borger,1448,231,,43,34,5,,1679
216,løn,305,23,,10,30,2,,328
217,borgerlønsniveauet,2,0,,1,2,0,,2
218,forsikring,2,0,,1,2,0,,2
219,faste,29,11,,4,7,3,,40
220,bund,478,73,,16,30,5,,551
221,grøn,2881,466,,110,26,4,,3347
222,hvorerderenvoksen,73,14,,2,36,7,,87
223,journalist,449,55,,20,22,3,,504
224,tråd,731,17,,9,81,2,,748
225,topskat,29,5,,5,6,1,,34
226,Kampen,43,9,,2,22,4,,52
227,økonomisk,1193,197,,44,27,4,,1390
228,ulighed,538,125,,24,22,5,,663
229,del,3575,395,,60,60,7,,3970
230,dna,3,3,,1,3,3,,6
231,Lisbeth,0,0,,1,0,0,,0
232,Skifergasbrønd,0,0,,1,0,0,,0
233,lynnedslag,0,0,,1,0,0,,0
234,Denton,0,0,,1,0,0,,0
235,Texas,0,0,,2,0,0,,0
236,Rasmus,698,68,,15,47,5,,766
237,Nordqvist,41,13,,3,14,4,,54
238,åbningstale,187,42,,6,31,7,,229
239,Done,33,0,,1,33,0,,33
240,beskæftigelsessystemet,18,7,,1,18,7,,25
241,https://t.co/bhvnCbwYha,18,7,,1,18,7,,25
242,UBI,2,3,,2,1,2,,5
243,partiprogram,4,2,,4,1,0,,6
244,penge,5457,597,,125,44,5,,6054
245,bæredygtig,689,84,,17,41,5,,773
246,teknologi,116,16,,8,14,2,,132
247,mulig,455,79,,29,16,3,,534
248,link,83,24,,13,6,2,,107
249,konkret,284,49,,13,22,4,,333
250,sag,1791,153,,57,31,3,,1944
251,https://t.co/FTgLc0f9ij,3,0,,1,3,0,,3
252,proportion,98,13,,2,49,6,,111
253,falsk,170,23,,8,21,3,,193
254,præmis,140,10,,4,35,2,,150
255,kontanthjælp,377,82,,21,18,4,,459
256,modkrav?@AlexanderSF_Bby,2,2,,1,2,2,,4
257,megen,4254,424,,83,51,5,,4678
258,lykke,356,62,,13,27,5,,418
259,Tusind,133,6,,7,19,1,,139
260,Peter,132,22,,7,19,3,,154
261,Livslang,23,16,,1,23,16,,39
262,førtidspension,106,37,,6,18,6,,143
263,førtidspensionist,113,33,,2,56,16,,146
264,fleksjobbe,23,16,,1,23,16,,39
265,frygt,91,23,,5,18,5,,114
266,fratagelse,23,16,,1,23,16,,39
267,pension,201,51,,14,14,4,,252
268,Fattigrøven,26,10,,1,26,10,,36
269,Troels,70,21,,5,14,4,,91
270,røv,179,48,,5,36,10,,227
271,God,2413,236,,63,38,4,,2649
272,start,621,115,,15,41,8,,736
273,Centrale,2,1,,1,2,1,,3
274,Handicapråds,2,1,,1,2,1,,3
275,Årsmøde,31,5,,2,16,2,,36
276,Interaktiv,2,1,,1,2,1,,3
277,dialog,1085,48,,11,99,4,,1133
278,https://t.co/cFa32wQWw2,2,1,,1,2,1,,3
279,Fock,9,7,,2,4,4,,16
280,fravær,289,21,,5,58,4,,310
281,miljømæssig,9,8,,2,4,4,,17
282,bundlinje,9,8,,3,3,3,,17
283,https://t.co/9vMuK7SmLc,9,7,,1,9,7,,16
284,org.,6,1,,1,6,1,,7
285,tiggergang,6,1,,1,6,1,,7
286,https://t.co/Hfr45Lcvfq,6,1,,1,6,1,,7
287,Torsten,54,6,,5,11,1,,60
288,fantastisk,1249,158,,29,43,5,,1407
289,kamp,1740,264,,50,35,5,,2004
290,gavne,70,14,,5,14,3,,84
291,opslag,58,2,,6,10,0,,60
292,Daniel,1,1,,2,0,0,,2
293,Oliver,49,4,,1,49,4,,53
294,Bureaukrati,7,2,,2,4,1,,9
295,kontrol,664,98,,25,27,4,,762
296,melding,326,47,,15,22,3,,373
297,cannabis,112,24,,6,19,4,,136
298,rocker,82,17,,1,82,17,,99
299,tvivl,1042,72,,26,40,3,,1114
300,https://t.co/0iMelK67xQ,82,17,,1,82,17,,99
301,sted,1711,284,,70,24,4,,1995
302,leve,41,10,,5,8,2,,51
303,https://t.co/df1ARxlQXU,24,8,,1,24,8,,32
304,sundhedsminister,5,1,,2,2,0,,6
305,samråd,1472,297,,35,42,8,,1769
306,genopretningspakke,3,2,,1,3,2,,5
307,negligere,3,2,,1,3,2,,5
308,aktivisme,3,2,,1,3,2,,5
309,https://t.co/XNZ3hsikfn,3,2,,1,3,2,,5
310,Mette,2461,423,,58,42,7,,2884
311,Frederiksen,1435,255,,28,51,9,,1690
312,forslag,2938,388,,91,32,4,,3326
313,brætte,79,20,,1,79,20,,99
314,spørgetime,273,47,,4,68,12,,320
315,folketingssal,424,60,,8,53,8,,484
316,indlæg,377,76,,15,25,5,,453
317,Erik,90,22,,3,30,7,,112
318,Christensen,99,23,,3,33,8,,122
319,Information,80,20,,2,40,10,,100
320,https://t.co/kUGzZ8kzOG,79,20,,1,79,20,,99
321,Mennesker,71,23,,5,14,5,,94
322,regel,1414,167,,35,40,5,,1581
323,Punktum,10,3,,4,2,1,,13
324,https://t.co/AWAGoIBHFc,7,3,,1,7,3,,10
325,Super,109,18,,5,22,4,,127
326,undtage,1,2,,2,0,1,,3
327,surre,180,27,,5,36,5,,207
328,chance,352,69,,11,32,6,,421
329,grønt,454,82,,16,28,5,,536
330,flertal,1939,260,,56,35,5,,2199
331,urigtighed,64,13,,1,64,13,,77
332,landsmøde,620,72,,12,52,6,,692
333,problem,1006,188,,72,14,3,,1194
334,ambitiøs,974,129,,14,70,9,,1103
335,sjællænder,6,10,,1,6,10,,16
336,Tornerosesøvn,6,10,,1,6,10,,16
337,fracking,6,10,,1,6,10,,16
338,kirkegård,74,26,,3,25,9,,100
339,http://t.co/P2OMogtabH,6,10,,1,6,10,,16
340,Thisted,26,4,,3,9,1,,30
341,biologisk,7,1,,2,4,0,,8
342,mangfoldighed,55,7,,4,14,2,,62
343,tydelighed,10,9,,1,10,9,,19
344,førtidspensionsforliget,10,9,,1,10,9,,19
345,https://t.co/WYbOZv9iZh,10,9,,1,10,9,,19
346,Ordningen,18,5,,3,6,2,,23
347,forudsætning,320,43,,5,64,9,,363
348,permanent,107,15,,6,18,2,,122
349,medicinsk,4,1,,2,2,0,,5
350,Naturterapi,1,2,,1,1,2,,3
351,virke,34,9,,3,11,3,,43
352,soldat,1,2,,1,1,2,,3
353,PTSD,1,2,,1,1,2,,3
354,stol,205,49,,4,51,12,,254
355,kødproduktion,142,32,,1,142,32,,174
356,Fødevarerordfører,142,32,,1,142,32,,174
357,Anders,215,40,,6,36,7,,255
358,Kronborg,142,32,,1,142,32,,174
359,vige,255,57,,7,36,8,,312
360,konference,388,67,,14,28,5,,455
361,fødevare,169,36,,5,34,7,,205
362,omstilling,1520,244,,37,41,7,,1764
363,bjælde,142,32,,1,142,32,,174
364,Nye,3042,480,,66,46,7,,3522
365,forringelse,108,42,,6,18,7,,150
366,flygtning,415,89,,28,15,3,,504
367,mulighed,3176,270,,56,57,5,,3446
368,rettighed,821,107,,18,46,6,,928
369,empati,103,25,,5,21,5,,128
370,dkasyl,3,1,,1,3,1,,4
371,tag,93,35,,3,31,12,,128
372,hoved,24,3,,6,4,0,,27
373,medlem,419,56,,26,16,2,,475
374,Fuldt,3,1,,1,3,1,,4
375,hus,449,24,,16,28,2,,473
376,halvårsmødet,3,1,,1,3,1,,4
377,Aarhus,297,66,,29,10,2,,363
378,fest,604,38,,7,86,5,,642
379,https://t.co/hAJr4Xxr2N,3,1,,1,3,1,,4
380,Positivt,1,0,,1,1,0,,1
381,Juncker,12,3,,2,6,2,,15
382,asylansøger,1,1,,2,0,0,,2
383,ansøgning,49,10,,4,12,2,,59
384,middel,382,55,,20,19,3,,437
385,nødhjælp,1,0,,1,1,0,,1
386,obligation,1,0,,1,1,0,,1
387,Baltic,14,4,,2,7,2,,18
388,Pipe,5,0,,1,5,0,,5
389,Total,355,52,,5,71,10,,407
390,Mand,1,1,,1,1,1,,2
391,gammel,713,72,,27,26,3,,785
392,Bronsonfan,1,1,,1,1,1,,2
393,ubi,5,5,,3,2,2,,10
394,modkrav,227,78,,10,23,8,,305
395,klare,2428,836,,74,33,11,,3264
396,rette,1447,200,,62,23,3,,1647
397,hjemmedyrkning,6,0,,1,6,0,,6
398,sort,273,46,,11,25,4,,319
399,energi,780,76,,14,56,5,,856
400,grad,340,69,,24,14,3,,409
401,opvarmning,44,12,,3,15,4,,56
402,kende,29,3,,3,10,1,,32
403,reservere,5,1,,1,5,1,,6
404,K.hjælpsloftet,16,8,,2,8,4,,24
405,Pronto,8,4,,1,8,4,,12
406,Verden,109,23,,3,36,8,,132
407,flerdimensionel,0,0,,1,0,0,,0
408,scene,12,2,,4,3,0,,14
409,lækker,2,1,,1,2,1,,3
410,fmdk,75,9,,8,9,1,,84
411,https://t.co/XM5wOAILQ7,2,1,,1,2,1,,3
412,Interessant,111,24,,6,18,4,,135
413,https://t.co/mSZvOOVBuV,16,8,,1,16,8,,24
414,Cevea,0,0,,1,0,0,,0
415,Consito,0,0,,1,0,0,,0
416,igang,490,87,,13,38,7,,577
417,UDENFOR,9,5,,1,9,5,,14
418,Fortum,9,5,,1,9,5,,14
419,Nyborg,72,10,,3,24,3,,82
420,farlig,225,29,,11,20,3,,254
421,affald,117,21,,5,23,4,,138
422,fjernvarme,85,19,,3,28,6,,104
423,https://t.co/Ysf8NJpKz5,9,5,,1,9,5,,14
424,alle-konkurrence,1,3,,1,1,3,,4
425,rig,1308,150,,19,69,8,,1458
426,https://t.co/vQ02nwaLTm,1,3,,1,1,3,,4
427,værst,337,49,,8,42,6,,386
428,klimamyter,3,3,,1,3,3,,6
429,klimamyteknuser,3,3,,1,3,3,,6
430,https://t.co/znuik1ucqm,3,3,,1,3,3,,6
431,fv15,234,95,,36,6,3,,329
432,https://t.co/FWcVlf79eC,0,0,,1,0,0,,0
433,forebyggelse,22,5,,2,11,2,,27
434,behandling,654,106,,13,50,8,,760
435,cannabismisbrug,6,1,,1,6,1,,7
436,hands,6,1,,1,6,1,,7
437,misbrugsbehandlerne,6,1,,1,6,1,,7
438,https://t.co/DnxKEGk9Ab,6,1,,1,6,1,,7
439,finansministerium,3,1,,1,3,1,,4
440,parti,5482,564,,94,58,6,,6046
441,borgerforslag,171,30,,3,57,10,,201
442,Parisaftalen,68,10,,2,34,5,,78
443,godte,1939,194,,71,27,3,,2133
444,Alternativist,55,6,,1,55,6,,61
445,diagnose,4,1,,2,2,0,,5
446,kultur,967,115,,26,37,4,,1082
447,Rådet,4,1,,3,1,0,,5
448,Kongens,2,2,,2,1,1,,4
449,Have,2,2,,2,1,1,,4
450,Odense,28,15,,6,5,2,,43
451,https://t.co/WZBQHfsIRh,2,1,,1,2,1,,3
452,NAU's,4,1,,1,4,1,,5
453,Ungebus,4,1,,1,4,1,,5
454,ankomme,4,1,,1,4,1,,5
455,ungdomshus,4,1,,1,4,1,,5
456,Walker,5,1,,2,2,0,,6
457,Big,4,1,,1,4,1,,5
458,https://t.co/ZEnuufhVkw,4,1,,1,4,1,,5
459,Hele,766,44,,10,77,4,,810
460,Love,12,0,,2,6,0,,12
461,air,8,0,,2,4,0,,8
462,Søde,8,0,,1,8,0,,8
463,gys,8,0,,1,8,0,,8
464,ryg,252,36,,8,32,4,,288
465,https://t.co/IeAhobcEcg,8,0,,1,8,0,,8
466,urimelighed,2,1,,2,1,0,,3
467,grund,2285,172,,34,67,5,,2457
468,FØP,43,19,,2,22,10,,62
469,reform,112,27,,17,7,2,,139
470,utallig,9,1,,3,3,0,,10
471,exe,1,0,,1,1,0,,1
472,konklusion,130,14,,6,22,2,,144
473,perspektiv,164,33,,8,20,4,,197
474,Moll,35,7,,1,35,7,,42
475,Wingender,35,7,,1,35,7,,42
476,Analyse,35,7,,1,35,7,,42
477,Tal,35,7,,2,18,4,,42
478,behov,1147,231,,33,35,7,,1378
479,medicin,415,60,,9,46,7,,475
480,fritidstilbud,35,7,,1,35,7,,42
481,skattestop,20,8,,1,20,8,,28
482,vare,20,8,,1,20,8,,28
483,produkt,223,35,,7,32,5,,258
484,adfærd,66,15,,5,13,3,,81
485,hockeystav,20,8,,1,20,8,,28
486,om.@alternativet,20,8,,1,20,8,,28
487,Rene,9,5,,2,4,2,,14
488,Gade,202,28,,4,50,7,,230
489,krig,33,13,,5,7,3,,46
490,Irak,9,5,,1,9,5,,14
491,Syrien,284,48,,8,36,6,,332
492,https://t.co/dNMTD5yqvE,9,5,,1,9,5,,14
493,Sjældne,31,10,,1,31,10,,41
494,Diagnoser,31,10,,1,31,10,,41
495,høring,116,36,,6,19,6,,152
496,stærk,2928,268,,43,68,6,,3196
497,panel,36,12,,2,18,6,,48
498,fagfolk,82,20,,4,20,5,,102
499,ekspert,165,37,,10,16,4,,202
500,politiker,3332,328,,67,50,5,,3660
501,specialisering,31,10,,1,31,10,,41
502,faglig,200,31,,16,12,2,,231
503,vide,319,55,,15,21,4,,374
504,https://t.co/rGyxBL4eF5,31,10,,1,31,10,,41
505,spørgsmål,1464,180,,72,20,2,,1644
506,forbruge,275,28,,2,138,14,,303
507,ting,2226,158,,40,56,4,,2384
508,landbrug,312,69,,22,14,3,,381
509,stoppe,383,57,,13,29,4,,440
510,olieboring,3,0,,1,3,0,,3
511,risiko,286,51,,12,24,4,,337
512,ordførerskaberne,25,3,,2,12,2,,28
513,beskæftigelse,356,33,,12,30,3,,389
514,arbejdsmarked,311,51,,19,16,3,,362
515,indenrigs,13,1,,1,13,1,,14
516,nævne,168,27,,6,28,4,,195
517,stole,1,0,,1,1,0,,1
518,bidrage,79,16,,4,20,4,,95
519,mening,881,147,,39,23,4,,1028
520,købsoplevelse,31,6,,1,31,6,,37
521,IKEA,31,6,,1,31,6,,37
522,anbringe,68,9,,3,23,3,,77
523,Hørt,68,6,,3,23,2,,74
524,Anbragtes,31,6,,1,31,6,,37
525,Vilkår,31,6,,1,31,6,,37
526,Laura,2,2,,2,1,1,,4
527,Finn,1,1,,1,1,1,,2
528,orden,345,47,,20,17,2,,392
529,Madsen,16,5,,3,5,2,,21
530,Kim,256,21,,7,37,3,,277
531,Gejl,1,1,,1,1,1,,2
532,Uanset,295,29,,8,37,4,,324
533,giftig,108,17,,4,27,4,,125
534,Lindahl,1,1,,1,1,1,,2
535,køn,325,44,,7,46,6,,369
536,praktik,4,0,,2,2,0,,4
537,klog,575,41,,25,23,2,,616
538,nytte,975,134,,39,25,3,,1109
539,Fint,2911,120,,12,243,10,,3031
540,tillidstema,103,12,,1,103,12,,115
541,verden,2380,340,,55,43,6,,2720
542,føre,137,21,,4,34,5,,158
543,tillidssamfund,103,12,,1,103,12,,115
544,abe,103,12,,1,103,12,,115
545,dabei,103,12,,1,103,12,,115
546,beskæftigelsessystem,120,18,,2,60,9,,138
547,mistillid,103,12,,2,52,6,,115
548,tillidsbegreb,103,12,,1,103,12,,115
549,Ses,45,2,,3,15,1,,47
550,loft,43,7,,5,9,1,,50
551,skyld,1423,152,,33,43,5,,1575
552,Regeringen,1040,152,,34,31,4,,1192
553,sværte,370,53,,29,13,2,,423
554,tegn,261,26,,9,29,3,,287
555,twitter,32,3,,6,5,0,,35
556,Slå,0,0,,1,0,0,,0
557,folketing,232,48,,16,14,3,,280
558,fobi,9,7,,1,9,7,,16
559,lidelse,18,11,,3,6,4,,29
560,platform,9,7,,1,9,7,,16
561,uvished,16,9,,2,8,4,,25
562,utryghed,62,13,,6,10,2,,75
563,https://t.co/6xT3eUXtXy,9,7,,1,9,7,,16
564,and,200,45,,5,40,9,,245
565,nytårstale,533,68,,6,89,11,,601
566,statsminister,7408,618,,62,119,10,,8026
567,videnskabelig,95,17,,2,48,8,,112
568,evidens,364,39,,6,61,6,,403
569,ønske,151,24,,8,19,3,,175
570,tvangsfjernelse,74,17,,1,74,17,,91
571,borgerløn,112,32,,5,22,6,,144
572,dejlig,731,79,,19,38,4,,810
573,Signe,7,1,,1,7,1,,8
574,radikal,746,125,,31,24,4,,871
575,psykiatriaftale,47,6,,1,47,6,,53
576,personale,209,64,,10,21,6,,273
577,akut,55,9,,3,18,3,,64
578,Flere,1494,164,,30,50,5,,1658
579,retspsykiatriske,47,6,,1,47,6,,53
580,plads,779,116,,40,19,3,,895
581,fokus,947,109,,27,35,4,,1056
582,depression,47,6,,1,47,6,,53
583,stress,78,7,,3,26,2,,85
584,psykisk,146,27,,5,29,5,,173
585,syge,607,86,,14,43,6,,693
586,️@keddeF,7,4,,1,7,4,,11
587,uanset,2,0,,2,1,0,,2
588,undskyldning,253,21,,8,32,3,,274
589,natte,196,43,,7,28,6,,239
590,mor,368,61,,14,26,4,,429
591,søn,330,40,,7,47,6,,370
592,skole,1600,230,,36,44,6,,1830
593,Knud,19,7,,2,10,4,,26
594,Aarup,15,5,,1,15,5,,20
595,Borgen@alternativet,15,5,,1,15,5,,20
596,Sagsbehandlerne,2,3,,1,2,3,,5
597,varme,202,22,,10,20,2,,224
598,hånd,1386,117,,27,51,4,,1503
599,servicere,2,3,,1,2,3,,5
600,cannabissagen,0,0,,1,0,0,,0
601,hån,12,2,,2,6,1,,14
602,håndværker,49,6,,2,24,3,,55
603,sejlmager,0,0,,1,0,0,,0
604,bartender,1,0,,3,0,0,,1
605,sæson,691,14,,4,173,4,,705
606,Lofoten,0,0,,1,0,0,,0
607,praktisk,12,0,,3,4,0,,12
608,skade,179,25,,7,26,4,,204
609,Sikke,829,52,,13,64,4,,881
610,grim,17,3,,3,6,1,,20
611,udtalelse,104,18,,6,17,3,,122
612,samarbejdspartner,64,11,,2,32,6,,75
613,Del,30,12,,3,10,4,,42
614,neoliberale,0,0,,1,0,0,,0
615,udvikling,741,122,,27,27,5,,863
616,afmagt,83,21,,3,28,7,,104
617,samfundsmæssig,51,18,,1,51,18,,69
618,moralskred,51,18,,1,51,18,,69
619,https://t.co/SXcsWZt78D,51,18,,1,51,18,,69
620,urimelig,336,62,,8,42,8,,398
621,Kontanthjælpsloftet,30,18,,5,6,4,,48
622,https://t.co/mgRsBMhdqs,8,4,,1,8,4,,12
623,aktuel,144,30,,7,21,4,,174
624,reduktion,275,61,,9,31,7,,336
625,udsættelse,24,12,,1,24,12,,36
626,klimaforhandling,131,37,,2,66,18,,168
627,https://t.co/J5SzVU6Ytz,24,12,,1,24,12,,36
628,kommisionen,0,0,,1,0,0,,0
629,Sjælden,8,1,,1,8,1,,9
630,enighed,16,4,,6,3,1,,20
631,foretræde,10,2,,2,5,1,,12
632,minister,1933,296,,66,29,4,,2229
633,tale,2761,181,,52,53,3,,2942
634,Bogreception,7,7,,1,7,7,,14
635,banegård,7,7,,1,7,7,,14
636,hjemløshed,146,31,,3,49,10,,177
637,https://t.co/1PiRw6j0la,7,7,,1,7,7,,14
638,Frivilligt,5,2,,1,5,2,,7
639,spareøvelse,11,3,,2,6,2,,14
640,unik,171,26,,6,28,4,,197
641,værdi,843,109,,19,44,6,,952
642,Fonden,5,2,,1,5,2,,7
643,Tivoli,5,2,,2,2,1,,7
644,https://t.co/20rfSiZjzs,5,2,,1,5,2,,7
645,strid,18,6,,6,3,1,,24
646,anbefaling,186,24,,16,12,2,,210
647,Putte,1,0,,1,1,0,,1
648,hår,39,3,,3,13,1,,42
649,håndslag,64,13,,3,21,4,,77
650,nødt,285,33,,12,24,3,,318
651,kommisionens,0,0,,1,0,0,,0
652,beslutning,1496,166,,36,42,5,,1662
653,reel,371,41,,17,22,2,,412
654,Josephine,31,6,,3,10,2,,37
655,bange,121,13,,8,15,2,,134
656,studenterkørslen,20,3,,1,20,3,,23
657,aflyse,64,9,,5,13,2,,73
658,alkohol,100,16,,5,20,3,,116
659,studenterkørsel,20,3,,1,20,3,,23
660,druk,21,3,,2,10,2,,24
661,banner,3,1,,3,1,0,,4
662,præsident,315,23,,9,35,3,,338
663,Vallonien,11,6,,1,11,6,,17
664,like,70,9,,4,18,2,,79
665,rose,48,8,,5,10,2,,56
666,CETA,60,25,,2,30,12,,85
667,Elever,17,2,,1,17,2,,19
668,indgribende,17,2,,1,17,2,,19
669,fysisk,26,4,,3,9,1,,30
670,fag,85,2,,2,42,1,,87
671,idræt,85,8,,3,28,3,,93
672,folkeskole,383,40,,18,21,2,,423
673,afgangseksamen,17,2,,1,17,2,,19
674,permanente,124,26,,5,25,5,,150
675,løsning,1341,188,,41,33,5,,1529
676,valgkampagne,35,7,,1,35,7,,42
677,alvor,149,29,,9,17,3,,178
678,elev,461,59,,16,29,4,,520
679,Katedralskolen,35,7,,1,35,7,,42
680,Teater,35,7,,1,35,7,,42
681,brise,35,7,,1,35,7,,42
682,miljøbevidsthed,35,7,,1,35,7,,42
683,håb,1064,99,,9,118,11,,1163
684,https://t.co/o80zFSJHVI,35,7,,1,35,7,,42
685,kontanthjælpsmodtager,90,31,,4,22,8,,121
686,socialøkonomisk,15,6,,1,15,6,,21
687,virksomhed,1693,221,,54,31,4,,1914
688,jul,422,23,,15,28,2,,445
689,fremtid,1552,228,,43,36,5,,1780
690,Landbruget,302,37,,3,101,12,,339
691,luftfart,3,0,,1,3,0,,3
692,industri,308,27,,4,77,7,,335
693,landtransport,3,0,,1,3,0,,3
694,affaldsområde,4,2,,2,2,1,,6
695,etc,62,4,,5,12,1,,66
696,klimalovgivning,3,0,,1,3,0,,3
697,visse,156,25,,4,39,6,,181
698,socialdemokratisk,586,59,,8,73,7,,645
699,forfordeling,3,0,,1,3,0,,3
700,Undtag,0,1,,1,0,1,,1
701,Skål,22,3,,2,11,2,,25
702,overskrift,287,33,,7,41,5,,320
703,Global,2,1,,1,2,1,,3
704,politikudvikling,2,1,,1,2,1,,3
705,fedt,61,3,,9,7,0,,64
706,https://t.co/okHEZUA2L7,2,1,,1,2,1,,3
707,kvalitet,168,40,,14,12,3,,208
708,evt.,28,11,,1,28,11,,39
709,S-regering,42,14,,3,14,5,,56
710,https://t.co/4PCAUv1Tn9,28,11,,1,28,11,,39
711,punkt,104,24,,6,17,4,,128
712,Civilsamfundet,18,5,,1,18,5,,23
713,fælllesskaber,18,5,,1,18,5,,23
714,offentlig,1928,185,,44,44,4,,2113
715,system,646,113,,19,34,6,,759
716,civilsamfund,24,7,,3,8,2,,31
717,fællesskabsmilliarden,18,5,,1,18,5,,23
718,Larsen,173,26,,6,29,4,,199
719,rige,415,83,,15,28,6,,498
720,Løkkes,139,20,,5,28,4,,159
721,playliste,15,8,,1,15,8,,23
722,https://t.co/Zg68nnh6KC,15,8,,1,15,8,,23
723,demo,86,26,,7,12,4,,112
724,Udd,8,0,,4,2,0,,8
725,besparelse,433,62,,13,33,5,,495
726,kost,265,30,,6,44,5,,295
727,evne,195,25,,6,32,4,,220
728,uddannelse,1276,179,,40,32,4,,1455
729,Specialtilbud,3,0,,1,3,0,,3
730,Juster,16,8,,1,16,8,,24
731,førtidsp.reformen,16,8,,1,16,8,,24
732,glæde,120,13,,8,15,2,,133
733,https://t.co/8EDM677CSN,16,8,,1,16,8,,24
734,Uffe,162,41,,8,20,5,,203
735,evaluering,96,28,,5,19,6,,124
736,https://t.co/4RKGUXf5w1,42,19,,1,42,19,,61
737,oversvømmelse,0,0,,1,0,0,,0
738,tørke,0,0,,1,0,0,,0
739,protest,13,4,,3,4,1,,17
740,trykteste,2,1,,1,2,1,,3
741,Nordjylland,320,40,,11,29,4,,360
742,Ulrik,32,8,,2,16,4,,40
743,ærlig,499,30,,12,42,2,,529
744,Søren,548,60,,18,30,3,,608
745,Ledige,19,11,,1,19,11,,30
746,tilbud,219,36,,5,44,7,,255
747,forlange,19,11,,1,19,11,,30
748,https://t.co/Ko1SF3VhSm,19,11,,1,19,11,,30
749,Dagens,1382,141,,15,92,9,,1523
750,Folkemødet,35,4,,3,12,1,,39
751,Bilbranchen,18,3,,1,18,3,,21
752,lufthavn,30,11,,5,6,2,,41
753,hybridbil,18,3,,1,18,3,,21
754,elbil,18,4,,4,4,1,,22
755,https://t.co/bi4zNxXUco,18,3,,1,18,3,,21
756,beskæftigelsesminister,202,47,,4,50,12,,249
757,afskaffelse,241,52,,7,34,7,,293
758,gensidig,1028,153,,7,147,22,,1181
759,Folketingssalen,644,52,,6,107,9,,696
760,https://t.co/SSvwp6Qmkm,61,18,,1,61,18,,79
761,pensionist,155,30,,8,19,4,,185
762,rigtig,1156,160,,41,28,4,,1316
763,tal,993,163,,31,32,5,,1156
764,Fedt,207,24,,9,23,3,,231
765,mand,3664,210,,43,85,5,,3874
766,budskab,283,59,,13,22,5,,342
767,ubegrænset,23,5,,1,23,5,,28
768,vækst,486,120,,31,16,4,,606
769,klode,483,40,,6,80,7,,523
770,resurse,60,13,,3,20,4,,73
771,enkelt,579,70,,23,25,3,,649
772,åbningsdebat,118,30,,5,24,6,,148
773,Folketinget,2108,181,,52,41,3,,2289
774,finansminister,139,26,,6,23,4,,165
775,udgift,185,29,,13,14,2,,214
776,tilbageløb,7,0,,1,7,0,,7
777,dymamiske,7,0,,1,7,0,,7
778,effekt,1339,126,,13,103,10,,1465
779,aflede,11,0,,2,6,0,,11
780,vintergruppemøde,6,2,,1,6,2,,8
781,bestyrelse,231,39,,7,33,6,,270
782,MF'ere,6,2,,1,6,2,,8
783,stab,6,2,,1,6,2,,8
784,landssekretariat,6,2,,1,6,2,,8
785,normal,89,15,,4,22,4,,104
786,https://t.co/Z1q8ghv4Gd,6,2,,1,6,2,,8
787,velfærd,1729,305,,51,34,6,,2034
788,fald,447,54,,28,16,2,,501
789,Konference,17,2,,2,8,1,,19
790,Askov,3,2,,1,3,2,,5
791,fond,254,23,,3,85,8,,277
792,https://t.co/q3oPo9SWyZ,3,2,,1,3,2,,5
793,velkommen,895,38,,10,90,4,,933
794,beløb,32,4,,8,4,0,,36
795,nej,790,113,,39,20,3,,903
796,Sagen,48,9,,5,10,2,,57
797,beskæft.ministeren,1,2,,1,1,2,,3
798,liberal,1188,134,,17,70,8,,1322
799,frihed,1170,184,,33,35,6,,1354
800,administration,257,56,,6,43,9,,313
801,diskusprolaps,94,7,,1,94,7,,101
802,kort,635,84,,20,32,4,,719
803,sygeorlov,94,7,,1,94,7,,101
804,25.,94,7,,1,94,7,,101
805,November,94,7,,1,94,7,,101
806,Overlader,94,7,,1,94,7,,101
807,sæde,94,7,,1,94,7,,101
808,Mira,188,14,,2,94,7,,202
809,ildsjæl,171,25,,4,43,6,,196
810,socialpolitisk,94,7,,1,94,7,,101
811,Tag,136,17,,4,34,4,,153
812,https://t.co/LbsRRfy6UU,94,7,,1,94,7,,101
813,kronik,405,78,,10,40,8,,483
814,forbedring,115,23,,4,29,6,,138
815,afvikling,207,44,,3,69,15,,251
816,fattigdomsreformerne,82,19,,1,82,19,,101
817,forældre,1373,117,,24,57,5,,1490
818,værdige,252,43,,5,50,9,,295
819,forvaltningsdomstole,15,3,,1,15,3,,18
820,Ankestyrelsen,71,11,,3,24,4,,82
821,sikre,462,64,,10,46,6,,526
822,forskning,110,21,,16,7,1,,131
823,morgendag,61,13,,4,15,3,,74
824,investering,490,30,,20,24,2,,520
825,sigt,155,31,,6,26,5,,186
826,takst,3,3,,1,3,3,,6
827,BPA'en,3,3,,1,3,3,,6
828,BPA,3,3,,1,3,3,,6
829,https://t.co/dt1JLDzzgq,3,3,,1,3,3,,6
830,tilbagerulning,1,0,,1,1,0,,1
831,bekymre,382,28,,4,96,7,,410
832,Administrationen,21,15,,1,21,15,,36
833,Udsæt,47,30,,2,24,15,,77
834,sol,103,28,,7,15,4,,131
835,forkert,581,63,,28,21,2,,644
836,mindretalsbeskyttelse,0,0,,1,0,0,,0
837,kæmpe,1796,170,,44,41,4,,1966
838,klimamin,28,8,,2,14,4,,36
839,idé,350,34,,11,32,3,,384
840,Energinet,9,4,,1,9,4,,13
841,infrastruktur,123,19,,9,14,2,,142
842,fossil,75,20,,8,9,2,,95
843,Pipe-projektet,9,4,,1,9,4,,13
844,Svar,134,54,,8,17,7,,188
845,Svaret,133,23,,9,15,3,,156
846,tusind,2,2,,4,0,0,,4
847,visionær,24,7,,2,12,4,,31
848,møde,1397,166,,29,48,6,,1563
849,spin,857,49,,8,107,6,,906
850,argumentation,44,17,,6,7,3,,61
851,vision,19,10,,6,3,2,,29
852,sørgelig,0,1,,2,0,0,,1
853,hjælpsloftet,31,7,,1,31,7,,38
854,børnefamilie,47,10,,4,12,2,,57
855,aktivitetsparate,31,7,,1,31,7,,38
856,https://t.co/mqyeqjwLpC,31,7,,1,31,7,,38
857,Prækariatet,1,0,,1,1,0,,1
858,alarmklokke,3,1,,1,3,1,,4
859,Nordjyske.dk,3,1,,1,3,1,,4
860,http://t.co/GsljxwWChR,3,1,,1,3,1,,4
861,Nedtællingen,3,1,,1,3,1,,4
862,dkudd,3,1,,1,3,1,,4
863,Fair,32,3,,10,3,0,,35
864,holdning,317,41,,37,9,1,,358
865,KAN,3,1,,1,3,1,,4
866,forbud,638,109,,15,43,7,,747
867,gøde,59,10,,1,59,10,,69
868,tusinde,191,34,,4,48,8,,225
869,hektar,59,10,,1,59,10,,69
870,paragraf,69,12,,3,23,4,,81
871,naturareal,59,10,,1,59,10,,69
872,fordel,205,29,,12,17,2,,234
873,insekt,76,13,,2,38,6,,89
874,plante,72,11,,2,36,6,,83
875,mose,59,10,,1,59,10,,69
876,eng,59,10,,1,59,10,,69
877,https://t.co/36FeUqtgi6,59,10,,1,59,10,,69
878,nedslidning,133,27,,4,33,7,,160
879,pokker,257,20,,5,51,4,,277
880,fokusere,25,9,,1,25,9,,34
881,sund,479,61,,10,48,6,,540
882,arbejdsliv,131,35,,6,22,6,,166
883,30-timers,25,9,,2,12,4,,34
884,arbejdsuge,325,26,,4,81,6,,351
885,dkarbejde,25,9,,1,25,9,,34
886,åbenhed,161,28,,8,20,4,,189
887,partitstøtten,0,0,,1,0,0,,0
888,Henrik,531,49,,14,38,4,,580
889,Sass,24,8,,2,12,4,,32
890,Møller,54,9,,2,27,4,,63
891,Mortensen,20,5,,1,20,5,,25
892,Trine,40,13,,3,13,4,,53
893,Bramsen,36,8,,2,18,4,,44
894,gruppeformand,399,6,,2,200,3,,405
895,Bidrager,6,3,,1,6,3,,9
896,erfaring,173,27,,11,16,2,,200
897,skabelse,6,3,,1,6,3,,9
898,bevægelse,58,15,,5,12,3,,73
899,bekæmpelse,39,11,,3,13,4,,50
900,ensomhed,91,15,,2,46,8,,106
901,hjemløseudspil,0,1,,1,0,1,,1
902,sidste,1734,220,,53,33,4,,1954
903,uge,1252,129,,49,26,3,,1381
904,udmelding,813,579,,8,102,72,,1392
905,styr,856,78,,16,54,5,,934
906,skid,26,15,,1,26,15,,41
907,venligvolution,26,15,,1,26,15,,41
908,logik,54,7,,6,9,1,,61
909,forsimple,1,0,,1,1,0,,1
910,Ungt,16,1,,1,16,1,,17
911,Håb,16,1,,1,16,1,,17
912,Esbjerg,63,4,,3,21,1,,67
913,Unge,74,9,,3,25,3,,83
914,udvikle,257,20,,2,128,10,,277
915,kommunal,209,35,,5,42,7,,244
916,ungepolitik,16,1,,1,16,1,,17
917,https://t.co/LYCDpK292B,16,1,,1,16,1,,17
918,systembrist,28,15,,1,28,15,,43
919,https://t.co/oPpsrGk4iH,28,15,,1,28,15,,43
920,side,864,117,,35,25,3,,981
921,prøvevagt,0,0,,1,0,0,,0
922,nette,13,5,,2,6,2,,18
923,eksamen,85,0,,2,42,0,,85
924,virkelighed,1340,129,,25,54,5,,1469
925,https://t.co/sJPmKddd1,13,6,,1,13,6,,19
926,bero,92,18,,1,92,18,,110
927,brede,349,54,,11,32,5,,403
928,beskæftigelsesministerium,99,18,,2,50,9,,117
929,Folkeklubben,19,3,,2,10,2,,22
930,Fedterøv,10,1,,1,10,1,,11
931,Naturmødet,10,1,,1,10,1,,11
932,Hirtshals,10,1,,1,10,1,,11
933,bud,152,28,,9,17,3,,180
934,klimalove,711,64,,2,356,32,,775
935,ben,84,12,,4,21,3,,96
936,https://t.co/0Utfal1Htk,37,5,,1,37,5,,42
937,Solenergi,1,0,,1,1,0,,1
938,bølgeenergi,21,4,,2,10,2,,25
939,termisk,1,0,,1,1,0,,1
940,Integration,264,14,,3,88,5,,278
941,asylpolitik,1,0,,2,0,0,,1
942,k.hjælpsloft,21,9,,1,21,9,,30
943,skattelettelse,342,47,,16,21,3,,389
944,https://t.co/8IjGwQiuAe,21,9,,1,21,9,,30
945,antagelse,13,2,,4,3,0,,15
946,fødselsdag,1027,76,,8,128,10,,1103
947,sport,3,1,,1,3,1,,4
948,retningslinje,371,51,,6,62,8,,422
949,risikogruppe,133,23,,3,44,8,,156
950,arbejdsfortjeneste,37,11,,1,37,11,,48
951,sårbar,358,61,,11,33,6,,419
952,https://t.co/oaIHb5Dpxq,37,11,,1,37,11,,48
953,partsaftale,2,1,,1,2,1,,3
954,ang.,43,3,,2,22,2,,46
955,praktikplads,19,8,,4,5,2,,27
956,Ros,558,43,,4,140,11,,601
957,part,16,2,,4,4,0,,18
958,https://t.co/ctJvLBg4OS,2,1,,1,2,1,,3
959,Rekrutteringen,1,1,,1,1,1,,2
960,hudflette,1,1,,1,1,1,,2
961,https://t.co/Tbfkex7JKP,1,1,,1,1,1,,2
962,Sabbat,2,0,,1,2,0,,2
963,studiestart,2,0,,1,2,0,,2
964,høj,1567,159,,66,24,2,,1726
965,gennemførelse,2,0,,2,1,0,,2
966,Langt,24,11,,2,12,6,,35
967,Carl,42,18,,2,21,9,,60
968,Holst,24,11,,1,24,11,,35
969,dagpenge,728,176,,19,38,9,,904
970,oprettelse,93,25,,3,31,8,,118
971,Center,44,11,,3,15,4,,55
972,Demokratiudvikling,32,10,,1,32,10,,42
973,Borgerinddragelse,32,10,,1,32,10,,42
974,Borgerting,32,10,,1,32,10,,42
975,Demokratikommissionen,37,11,,2,18,6,,48
976,organ,32,10,,1,32,10,,42
977,demokrati,3851,290,,34,113,9,,4141
978,dkdemokrati,37,11,,2,18,6,,48
979,https://t.co/6ApFUOR95e,32,10,,1,32,10,,42
980,Mange,358,56,,29,12,2,,414
981,medl,5,1,,1,5,1,,6
982,aktiv,179,28,,7,26,4,,207
983,Okay,32,5,,3,11,2,,37
984,Debat,708,64,,7,101,9,,772
985,BIEN,20,9,,1,20,9,,29
986,Multispændende,20,9,,1,20,9,,29
987,ifht,20,9,,3,7,3,,29
988,Robotisering,20,9,,1,20,9,,29
989,https://t.co/IWUWxwPzbD,20,9,,1,20,9,,29
990,valgdag,882,58,,3,294,19,,940
991,regeringsgrundlag,14,2,,2,7,1,,16
992,årsag,1371,88,,11,125,8,,1459
993,katastrofe,433,83,,10,43,8,,516
994,Kraka,0,0,,1,0,0,,0
995,Lovløs,17,15,,1,17,15,,32
996,zone,18,15,,2,9,8,,33
997,f.tinget,17,15,,1,17,15,,32
998,parlementarisk,17,15,,1,17,15,,32
999,undersøgelse,107,21,,13,8,2,,128
1000,https://t.co/A8p7joyowY,17,15,,1,17,15,,32
1001,spænde,398,35,,17,23,2,,433
1002,erfaringsopsamling,33,7,,1,33,7,,40
1003,Dansk,2146,174,,25,86,7,,2320
1004,Socialrådgiverforening,33,7,,1,33,7,,40
1005,ophævelse,33,7,,1,33,7,,40
1006,pligt,321,45,,9,36,5,,366
1007,https://t.co/MrRzxBQKsr,33,7,,1,33,7,,40
1008,genoplive,2,0,,1,2,0,,2
1009,kommunalstyret,2,0,,1,2,0,,2
1010,Vigtig,145,32,,7,21,5,,177
1011,B16,2,0,,1,2,0,,2
1012,arbejdstid,42,15,,5,8,3,,57
1013,produktivitet,0,0,,1,0,0,,0
1014,bog,444,43,,20,22,2,,487
1015,Reformramte,98,39,,2,49,20,,137
1016,Jobcentrets,65,17,,2,32,8,,82
1017,Ofre,65,17,,2,32,8,,82
1018,Næstehjælperne,65,17,,2,32,8,,82
1019,Forlaget,57,16,,1,57,16,,73
1020,Bogen,57,16,,1,57,16,,73
1021,appel,57,16,,1,57,16,,73
1022,fleksjobreformen,57,16,,1,57,16,,73
1023,værdighed,71,23,,5,14,5,,94
1024,https://t.co/e6GfheP1n0,57,16,,1,57,16,,73
1025,tænkelig,19,2,,2,10,1,,21
1026,forvej,239,31,,11,22,3,,270
1027,ligestillingsudfordring,1,2,,1,1,2,,3
1028,Krav,40,12,,1,40,12,,52
1029,Kæmp,40,12,,1,40,12,,52
1030,Indførelse,40,12,,1,40,12,,52
1031,Gratis,40,12,,1,40,12,,52
1032,transport,590,66,,9,66,7,,656
1033,Afgiftsfritagelse,40,12,,1,40,12,,52
1034,brintbiler,40,12,,1,40,12,,52
1035,svar,1402,211,,63,22,3,,1613
1036,Mai,94,14,,5,19,3,,108
1037,satspuljeforlig,4,1,,1,4,1,,5
1038,Stig,34,5,,3,11,2,,39
1039,Langvad,0,1,,1,0,1,,1
1040,handicapkonventionen,0,1,,1,0,1,,1
1041,tøddel,0,1,,1,0,1,,1
1042,paradigmeskift,2,1,,2,1,0,,3
1043,dchårsmøde,0,1,,1,0,1,,1
1044,øjeblikkelig,1,3,,1,1,3,,4
1045,skifergas,20,20,,5,4,4,,40
1046,prøveboring,1,3,,1,1,3,,4
1047,Febr.,0,0,,1,0,0,,0
1048,KBH,0,0,,1,0,0,,0
1049,Bedsteforældrenes,10,1,,1,10,1,,11
1050,klimaaktion,10,1,,1,10,1,,11
1051,brandtale,10,1,,1,10,1,,11
1052,klimamarchen,11,2,,2,6,1,,13
1053,sej,1006,66,,20,50,3,,1072
1054,brand,99,15,,4,25,4,,114
1055,https://t.co/ZRDKXYr1Ds,10,1,,1,10,1,,11
1056,Arne,80,7,,3,27,2,,87
1057,gidsel,198,22,,5,40,4,,220
1058,politisk,2332,334,,86,27,4,,2666
1059,spil,25,7,,5,5,1,,32
1060,Mon,178,29,,11,16,3,,207
1061,tidlig,670,121,,31,22,4,,791
1062,tilbagetrækning,124,37,,6,21,6,,161
1063,tvinge,217,38,,5,43,8,,255
1064,https://t.co/0H6LPimoAZ,17,6,,1,17,6,,23
1065,klar,203,35,,12,17,3,,238
1066,aftale,5648,433,,76,74,6,,6081
1067,rød,1653,99,,24,69,4,,1752
1068,forventning,19,1,,4,5,0,,20
1069,S-ledet,39,5,,2,20,2,,44
1070,https://t.co/WSJb8sLSBP,3,1,,1,3,1,,4
1071,disrespekt,163,16,,2,82,8,,179
1072,misbruger,3,0,,2,2,0,,3
1073,modsætte,124,12,,10,12,1,,136
1074,Energiministeren,0,0,,1,0,0,,0
1075,skifergas-boringer,0,0,,1,0,0,,0
1076,klarhed,13,2,,3,4,1,,15
1077,kaos,30,11,,3,10,4,,41
1078,dkGreen,0,0,,1,0,0,,0
1079,http://t.co/oIr7kcANp2,0,0,,1,0,0,,0
1080,alverden,36,10,,3,12,3,,46
1081,statskasse,62,14,,5,12,3,,76
1082,opbakning,2077,174,,36,58,5,,2251
1083,demonstrant,800,102,,3,267,34,,902
1084,titusinder,14,4,,1,14,4,,18
1085,https://t.co/nFZC2iUxxM,14,4,,1,14,4,,18
1086,Enkelte,2,1,,1,2,1,,3
1087,særtilskud,2,2,,1,2,2,,4
1088,Borgerlige,2077,294,,42,49,7,,2371
1089,Set,49,9,,3,16,3,,58
1090,lys,56,11,,3,19,4,,67
1091,klimakrisen,623,80,,11,57,7,,703
1092,Europa,726,125,,21,35,6,,851
1093,projekt,501,57,,10,50,6,,558
1094,gravearbejder,19,4,,1,19,4,,23
1095,Lyt,876,114,,7,125,16,,990
1096,universitet,180,25,,6,30,4,,205
1097,tvungen,101,9,,4,25,2,,110
1098,eksamenstilmelding,4,0,,1,4,0,,4
1099,Antallet,21,4,,3,7,1,,25
1100,reeksamener,4,0,,1,4,0,,4
1101,eksplodere,4,0,,1,4,0,,4
1102,Uddpol,4,0,,1,4,0,,4
1103,http://t.co/qLFKByGNd1,4,0,,1,4,0,,4
1104,væske,3,0,,2,2,0,,3
1105,Samråd,127,29,,4,32,7,,156
1106,Landstingssalen,44,10,,1,44,10,,54
1107,tilmelding,44,10,,1,44,10,,54
1108,borgerforslaget,88,27,,2,44,14,,115
1109,banalitet,7,4,,1,7,4,,11
1110,rage,17,7,,2,8,4,,24
1111,Møder,40,24,,2,20,12,,64
1112,øverst,191,29,,4,48,7,,220
1113,halvdel,133,33,,8,17,4,,166
1114,https://t.co/KurlXOtuOz,14,5,,1,14,5,,19
1115,udligningsaftalen,56,9,,1,56,9,,65
1116,stat,2195,236,,37,59,6,,2431
1117,Bureaukratiet,56,9,,1,56,9,,65
1118,Afskaffelsen,56,9,,1,56,9,,65
1119,magistrat,56,9,,1,56,9,,65
1120,Husk,35,13,,2,18,6,,48
1121,onsdag,301,39,,6,50,6,,340
1122,København,1973,194,,28,70,7,,2167
1123,Randers,30,16,,4,8,4,,46
1124,hjemløseindsatsen,28,3,,2,14,2,,31
1125,ekstra,864,146,,36,24,4,,1010
1126,staspulje,4,0,,1,4,0,,4
1127,Gode,705,51,,14,50,4,,756
1128,nyhed,1594,208,,19,84,11,,1802
1129,årig,51,6,,3,17,2,,57
1130,Nikoline,45,6,,1,45,6,,51
1131,Hillers,45,6,,1,45,6,,51
1132,Skanderborg,45,6,,2,22,3,,51
1133,aftryk,56,8,,3,19,3,,64
1134,finanslov,1756,276,,45,39,6,,2032
1135,pulje,89,10,,4,22,2,,99
1136,ung,250,17,,5,50,3,,267
1137,iværksætteri,57,7,,4,14,2,,64
1138,dkmedier,1429,247,,47,30,5,,1676
1139,https://t.co/DiaENKy02c,45,6,,1,45,6,,51
1140,flødeskum,0,0,,1,0,0,,0
1141,toppe,325,34,,6,54,6,,359
1142,videnskab,361,65,,3,120,22,,426
1143,eventyr,15,2,,2,8,1,,17
1144,Sønnen,0,0,,1,0,0,,0
1145,autisme,0,0,,1,0,0,,0
1146,uklar,9,2,,5,2,0,,11
1147,Lukker,2,0,,1,2,0,,2
1148,Livslinien,2,0,,1,2,0,,2
1149,opkald,2,0,,1,2,0,,2
1150,vagtlæge,2,0,,1,2,0,,2
1151,psykiatrisk,71,14,,2,36,7,,85
1152,modtagelse,2,0,,1,2,0,,2
1153,socail,2,0,,1,2,0,,2
1154,husly,1,0,,1,1,0,,1
1155,nyliberalisme,1,0,,1,1,0,,1
1156,gal,30,8,,3,10,3,,38
1157,prioritering,152,39,,8,19,5,,191
1158,friskole,128,19,,11,12,2,,147
1159,Friskoler,25,5,,1,25,5,,30
1160,lokalsamfund,25,5,,1,25,5,,30
1161,genoverveje,25,5,,1,25,5,,30
1162,skolechat,256,69,,26,10,3,,325
1163,ffl20,25,5,,1,25,5,,30
1164,fremtidig,187,35,,6,31,6,,222
1165,omfordelingsprojekter,23,7,,1,23,7,,30
1166,mod,604,60,,8,76,8,,664
1167,støtteparti,395,46,,6,66,8,,441
1168,vild,395,54,,14,28,4,,449
1169,ubelejlig,6,3,,1,6,3,,9
1170,Borgeren,9,4,,1,9,4,,13
1171,historie,1698,224,,37,46,6,,1922
1172,sagsbehandle,9,4,,1,9,4,,13
1173,https://t.co/z2A0loznxB,9,4,,1,9,4,,13
1174,indspil,1,0,,2,0,0,,1
1175,centrum,123,10,,5,25,2,,133
1176,venstreflertal,6,2,,1,6,2,,8
1177,handelsaftale,50,20,,2,25,10,,70
1178,stopCETA,49,19,,1,49,19,,68
1179,https://t.co/ExPQ9x83VA,15,6,,1,15,6,,21
1180,glad,2076,172,,44,47,4,,2248
1181,Erfaren,0,0,,1,0,0,,0
1182,advokat,40,5,,4,10,1,,45
1183,kraftfuld,10,11,,1,10,11,,21
1184,kritik,653,94,,16,41,6,,747
1185,handicapudspil,10,11,,1,10,11,,21
1186,Kirsten,16,14,,2,8,7,,30
1187,Ketscher,10,11,,1,10,11,,21
1188,rettighedsmassakre,10,11,,1,10,11,,21
1189,https://t.co/VBZTL6u1PA,10,11,,1,10,11,,21
1190,pointe,527,59,,25,21,2,,586
1191,førtispension,0,0,,1,0,0,,0
1192,afklaring,13,2,,3,4,1,,15
1193,arbejdslyst,0,0,,1,0,0,,0
1194,vegetarburgerunderøgelse,2,0,,1,2,0,,2
1195,mur,41,8,,4,10,2,,49
1196,tyk,19,4,,3,6,1,,23
1197,klogskab,10,2,,1,10,2,,12
1198,folkelig,151,22,,6,25,4,,173
1199,Corona,482,74,,16,30,5,,556
1200,virus,1052,50,,7,150,7,,1102
1201,https://t.co/2z9swHfBfx,59,5,,1,59,5,,64
1202,Gitte,1,0,,1,1,0,,1
1203,Seebergs,1,0,,1,1,0,,1
1204,kommentar,819,64,,15,55,4,,883
1205,klimaflygtninge,1,0,,1,1,0,,1
1206,Kontanthjælps,3,2,,1,3,2,,5
1207,optimistisk,5,2,,2,2,1,,7
1208,sagsbeh,3,2,,1,3,2,,5
1209,samfundskontrakten,3,2,,1,3,2,,5
1210,fri,533,68,,20,27,3,,601
1211,Folk,109,23,,11,10,2,,132
1212,kontrakt,5,2,,3,2,1,,7
1213,️@AlexanderSF_Bby,3,2,,1,3,2,,5
1214,længde,140,18,,3,47,6,,158
1215,menneskelig,261,21,,5,52,4,,282
1216,Thumbs,2,1,,1,2,1,,3
1217,up-demo,2,1,,1,2,1,,3
1218,lokalpolitiker,2,1,,1,2,1,,3
1219,Frederikshavn,5,3,,2,2,2,,8
1220,Fortsæt,24,2,,3,8,1,,26
1221,http://t.co/aCSlH6ftKl,2,1,,1,2,1,,3
1222,påstand,292,27,,15,19,2,,319
1223,Nej,99,9,,29,3,0,,108
1224,milliardbesparelse,1,0,,2,0,0,,1
1225,29.,0,0,,1,0,0,,0
1226,oktober,110,19,,6,18,3,,129
1227,uddannelsesområde,86,14,,3,29,5,,100
1228,http://t.co/D70bD4BbDi,0,0,,1,0,0,,0
1229,normering,222,36,,9,25,4,,258
1230,forhandling,2109,230,,36,59,6,,2339
1231,boligydelse,41,10,,3,14,3,,51
1232,Svage,36,8,,1,36,8,,44
1233,dødelighed,36,8,,1,36,8,,44
1234,soc.,67,17,,1,67,17,,84
1235,mini,67,17,,1,67,17,,84
1236,lovlig,229,43,,9,25,5,,272
1237,ulovlig,1675,179,,21,80,9,,1854
1238,privat,1240,131,,26,48,5,,1371
1239,konsulent,219,50,,5,44,10,,269
1240,provision,67,17,,1,67,17,,84
1241,handicapområde,269,50,,7,38,7,,319
1242,dkhandicap,67,17,,1,67,17,,84
1243,fejl,1145,143,,27,42,5,,1288
1244,afgørelse,122,23,,4,30,6,,145
1245,Kassetænkning,62,14,,1,62,14,,76
1246,https://t.co/0sFvoeV1rP,62,14,,1,62,14,,76
1247,lokale,403,66,,15,27,4,,469
1248,kraft,1509,110,,8,189,14,,1619
1249,herlig,71,13,,2,36,6,,84
1250,Limfjordsø,8,4,,1,8,4,,12
1251,Egholm,13,6,,2,6,3,,19
1252,motorvejsføring,8,4,,1,8,4,,12
1253,Lov,46,10,,2,23,5,,56
1254,Jensen,205,33,,8,26,4,,238
1255,ændre,4,0,,2,2,0,,4
1256,strategisk,199,31,,3,66,10,,230
1257,samarbejde,1527,203,,39,39,5,,1730
1258,Indien,29,10,,3,10,3,,39
1259,dansk,8341,1204,,168,50,7,,9545
1260,arbejdsplads,247,78,,22,11,4,,325
1261,Norden,13,6,,1,13,6,,19
1262,klimabistand,13,6,,1,13,6,,19
1263,hjemmeside,35,2,,4,9,0,,37
1264,Sindssygt,50,22,,1,50,22,,72
1265,vedkomme,140,69,,2,70,34,,209
1266,https://t.co/45pAlyc1yu,50,22,,1,50,22,,72
1267,fornøjelse,315,23,,13,24,2,,338
1268,tekst,21,3,,4,5,1,,24
1269,artikel,392,77,,28,14,3,,469
1270,Altinget,19,1,,3,6,0,,20
1271,Britta,52,5,,3,17,2,,57
1272,N.’s,24,3,,1,24,3,,27
1273,svindel,27,4,,3,9,1,,31
1274,Satspuljen,24,3,,1,24,3,,27
1275,lykkes,2,3,,1,2,3,,5
1276,feste,2,3,,1,2,3,,5
1277,klimamarch,140,19,,2,70,10,,159
1278,hovedstad,56,11,,3,19,4,,67
1279,grande,35,7,,1,35,7,,42
1280,Karolinelund,35,7,,1,35,7,,42
1281,https://t.co/Lcm7FClPbR,35,7,,1,35,7,,42
1282,hul,68,12,,5,14,2,,80
1283,Stop,112,22,,8,14,3,,134
1284,news,113,13,,5,23,3,,126
1285,eksempel,902,125,,27,33,5,,1027
1286,forretning,85,18,,4,21,4,,103
1287,overskud,307,15,,10,31,2,,322
1288,særlig,58,1,,9,6,0,,59
1289,studentervogn,1,0,,1,1,0,,1
1290,voksen,395,54,,13,30,4,,449
1291,forbrug,126,21,,11,11,2,,147
1292,refinansiering,54,15,,1,54,15,,69
1293,lukning,397,72,,5,79,14,,469
1294,satspulje,65,17,,3,22,6,,82
1295,blodbad,58,19,,2,29,10,,77
1296,dkpool,54,15,,1,54,15,,69
1297,optur,0,0,,1,0,0,,0
1298,inddragelse,73,19,,5,15,4,,92
1299,Christian,42,8,,5,8,2,,50
1300,Nissen,5,1,,1,5,1,,6
1301,Jørgen,5,2,,2,2,1,,7
1302,Grønnegaard,5,1,,1,5,1,,6
1303,https://t.co/Sc3TyViSAR,5,1,,1,5,1,,6
1304,indstilling,15,2,,2,8,1,,17
1305,Førtids,34,14,,1,34,14,,48
1306,fleksreformen,34,14,,1,34,14,,48
1307,strammer,34,14,,1,34,14,,48
1308,nødvendig,633,121,,23,28,5,,754
1309,Thor,10,0,,1,10,0,,10
1310,vind,17,3,,4,4,1,,20
1311,sejl,13,0,,2,6,0,,13
1312,Hønge,726,34,,4,182,8,,760
1313,løfte,610,74,,13,47,6,,684
1314,forligskreds,18,4,,2,9,2,,22
1315,Bruuns,0,0,,1,0,0,,0
1316,Galleri,0,0,,1,0,0,,0
1317,gennemgribende,24,3,,1,24,3,,27
1318,opfølgning,33,4,,3,11,1,,37
1319,virksom,24,3,,1,24,3,,27
1320,metode,47,3,,3,16,1,,50
1321,Kassetænkningen,24,3,,1,24,3,,27
1322,hjemløsepolitiken,24,3,,1,24,3,,27
1323,https://t.co/JbgxUSgfnE,24,3,,1,24,3,,27
1324,telt,28,3,,5,6,1,,31
1325,https://t.co/w04LI0VZI3,1,0,,1,1,0,,1
1326,Dejlig,16,4,,3,5,1,,20
1327,tur,304,28,,13,23,2,,332
1328,Limfjordsøen,5,2,,1,5,2,,7
1329,åben,130,24,,9,14,3,,154
1330,arrangement,38,14,,7,5,2,,52
1331,aften,1082,114,,45,24,3,,1196
1332,mund,659,24,,6,110,4,,683
1333,sæbe,1,0,,1,1,0,,1
1334,Lynge,1,0,,1,1,0,,1
1335,etablering,10,2,,2,5,1,,12
1336,drift,40,4,,5,8,1,,44
1337,naturnationalparker,8,2,,1,8,2,,10
1338,udbud,271,17,,9,30,2,,288
1339,friluftsaktivitet,8,2,,1,8,2,,10
1340,NGO,34,9,,2,17,4,,43
1341,opgave,795,75,,26,31,3,,870
1342,dknatur,60,13,,2,30,6,,73
1343,https://t.co/Gypa4d8ONi,8,2,,1,8,2,,10
1344,uenig,154,11,,18,9,1,,165
1345,brugerbetaling,38,16,,6,6,3,,54
1346,Katastrofen,12,4,,1,12,4,,16
1347,vært,63,13,,4,16,3,,76
1348,konf,22,8,,1,22,8,,30
1349,Elbæk,111,20,,5,22,4,,131
1350,Guy,22,8,,1,22,8,,30
1351,Standing,22,8,,1,22,8,,30
1352,digital,623,81,,11,57,7,,704
1353,indikator,2,0,,1,2,0,,2
1354,forarmelse,2,0,,1,2,0,,2
1355,socpol,2,0,,1,2,0,,2
1356,socialpol,13,2,,2,6,1,,15
1357,Korrekt,1,2,,4,0,0,,3
1358,Uligheden,1,1,,1,1,1,,2
1359,pleje,65,19,,4,16,5,,84
1360,kl.,313,38,,12,26,3,,351
1361,socialminister,171,33,,4,43,8,,204
1362,dokumentation,77,11,,6,13,2,,88
1363,kraftig,119,32,,4,30,8,,151
1364,indgreb,167,23,,10,17,2,,190
1365,Ret,185,29,,2,92,14,,214
1366,plaster,293,44,,3,98,15,,337
1367,nedsættelse,28,11,,1,28,11,,39
1368,Alt,202,45,,15,13,3,,247
1369,efterlade,74,17,,2,37,8,,91
1370,arbejdsmarkedet.#dkpol,28,11,,1,28,11,,39
1371,Ministerens,72,15,,2,36,8,,87
1372,Departementchef,52,14,,1,52,14,,66
1373,krystal,52,14,,1,52,14,,66
1374,Støjberg,2115,135,,14,151,10,,2250
1375,undtagelsesfri,52,14,,1,52,14,,66
1376,ægtepar,55,15,,2,28,8,,70
1377,embedsværk,101,30,,4,25,8,,131
1378,vagt,240,33,,4,60,8,,273
1379,gevær,52,14,,1,52,14,,66
1380,udligning,429,43,,6,72,7,,472
1381,budgetloven,11,3,,2,6,2,,14
1382,opsparing,9,3,,2,4,2,,12
1383,klimasikring,7,2,,1,7,2,,9
1384,klimainvesteringer,7,2,,1,7,2,,9
1385,Job,7,2,,1,7,2,,9
1386,done,131,17,,4,33,4,,148
1387,itu,0,0,,1,0,0,,0
1388,Pelle,505,26,,14,36,2,,531
1389,Ændringerne,2,1,,1,2,1,,3
1390,forhandlingslokalet,2,1,,1,2,1,,3
1391,forligspart,2,1,,1,2,1,,3
1392,vrøvl,49,9,,5,10,2,,58
1393,faktum,118,27,,17,7,2,,145
1394,Nyt,25,3,,5,5,1,,28
1395,Nordjysk,2,2,,1,2,2,,4
1396,folketingsår,2,2,,1,2,2,,4
1397,Nordjyske,2,5,,2,1,2,,7
1398,projktr,2,2,,1,2,2,,4
1399,bundl,2,2,,1,2,2,,4
1400,national,318,63,,13,24,5,,381
1401,relevans,2,2,,1,2,2,,4
1402,https://t.co/ESmyHJKA6B,2,2,,1,2,2,,4
1403,fortælling,174,11,,5,35,2,,185
1404,pave,4,0,,1,4,0,,4
1405,kritisk,810,83,,12,68,7,,893
1406,Demo,17,4,,2,8,2,,21
1407,anstændig,18,1,,2,9,0,,19
1408,Slotspladsen,28,0,,3,9,0,,28
1409,https://t.co/XoSd5vmY3E,4,0,,1,4,0,,4
1410,gradbøje,1,1,,1,1,1,,2
1411,værdig,1374,121,,4,344,30,,1495
1412,Kbh,55,7,,5,11,1,,62
1413,Resultatlønninger,2,1,,1,2,1,,3
1414,sagsbehandlere/,2,1,,1,2,1,,3
1415,Socialchefer,2,1,,1,2,1,,3
1416,rekruttering,2,1,,2,1,0,,3
1417,Fakta,390,28,,2,195,14,,418
1418,fornuft,518,53,,11,47,5,,571
1419,tweets,50,1,,5,10,0,,51
1420,grov,18,9,,3,6,3,,27
1421,løgn,141,34,,8,18,4,,175
1422,Jesper,89,10,,3,30,3,,99
1423,anekdotisk,0,0,,1,0,0,,0
1424,useriøs,1,0,,1,1,0,,1
1425,anonym,1,0,,2,0,0,,1
1426,profil,21,3,,2,10,2,,24
1427,argument,398,39,,20,20,2,,437
1428,håne,1,0,,1,1,0,,1
1429,Lettere,4,11,,1,4,11,,15
1430,fejlslagen,4,11,,1,4,11,,15
1431,https://t.co/OImZT21YPu,4,11,,1,4,11,,15
1432,fede,25,5,,1,25,5,,30
1433,tilfælde,52,9,,7,7,1,,61
1434,kreditforening,0,0,,1,0,0,,0
1435,krigskassen,15,2,,2,8,1,,17
1436,kreditværdighed,0,0,,1,0,0,,0
1437,kasse,72,23,,6,12,4,,95
1438,vælger,545,40,,15,36,3,,585
1439,tænde,4,4,,2,2,2,,8
1440,https://t.co/jF5kUjQkrk,0,1,,1,0,1,,1
1441,finansiering,56,15,,13,4,1,,71
1442,Veksle,0,1,,1,0,1,,1
1443,lønstigning,0,1,,1,0,1,,1
1444,fritid,9,1,,2,4,0,,10
1445,knap,5,3,,1,5,3,,8
1446,ansvarlig,377,57,,11,34,5,,434
1447,https://t.co/MfhOGdylZN,30,9,,1,30,9,,39
1448,Ungepolitik,11,8,,1,11,8,,19
1449,Ungdommens,11,8,,1,11,8,,19
1450,Folkemøde,16,8,,2,8,4,,24
1451,Søndermarken,11,8,,1,11,8,,19
1452,Kbh.,25,10,,3,8,3,,35
1453,https://t.co/i7E26nMr1Y,11,8,,1,11,8,,19
1454,aftaletekst,72,10,,2,36,5,,82
1455,slutforhandlingerne,0,0,,1,0,0,,0
1456,Ministeren,174,27,,12,14,2,,201
1457,Nina,90,22,,2,45,11,,112
1458,Tengberg,38,13,,1,38,13,,51
1459,stemme,2362,267,,42,56,6,,2629
1460,umiddelbar,38,14,,2,19,7,,52
1461,https://t.co/S1luW5z1Qw,38,13,,1,38,13,,51
1462,Hjælp,80,12,,7,11,2,,92
1463,studium,46,21,,4,12,5,,67
1464,uddalliancen,1,0,,1,1,0,,1
1465,https://t.co/o1pPKKauzw,1,0,,1,1,0,,1
1466,uniudd,0,0,,1,0,0,,0
1467,eliteuniversitet,0,0,,1,0,0,,0
1468,Hjørring,44,18,,3,15,6,,62
1469,søndag,296,58,,13,23,4,,354
1470,https://t.co/uYQScNuc7z,1,1,,1,1,1,,2
1471,finsk,180,31,,2,90,16,,211
1472,besk.system,83,22,,1,83,22,,105
1473,https://t.co/BjIByGcOBy,83,22,,1,83,22,,105
1474,https://t.co/Pk66EfeITF,5,2,,1,5,2,,7
1475,lyttemøde,9,2,,1,9,2,,11
1476,Bekæmp,30,9,,3,10,3,,39
1477,Fattigdom,17,3,,2,8,2,,20
1478,lytte,189,28,,6,32,5,,217
1479,Sygedagpenge,11,3,,1,11,3,,14
1480,gruppe,1035,102,,16,65,6,,1137
1481,sygeplejerske,725,63,,10,72,6,,788
1482,covid19dk,115,15,,3,38,5,,130
1483,hjælpepakke,1186,85,,16,74,5,,1271
1484,Verdensmål,129,12,,2,64,6,,141
1485,Verdensmålskonference,13,3,,1,13,3,,16
1486,Kæmpe,946,105,,13,73,8,,1051
1487,forskel,878,47,,20,44,2,,925
1488,pige,913,60,,15,61,4,,973
1489,selvværd,11,1,,1,11,1,,12
1490,dkpolitik,11,1,,1,11,1,,12
1491,https://t.co/boKKjS7R8L,108,34,,1,108,34,,142
1492,Hurtige,3,3,,1,3,3,,6
1493,afstemning,91,17,,7,13,2,,108
1494,korte,52,17,,3,17,6,,69
1495,dynamisk,258,27,,3,86,9,,285
1496,form,219,32,,15,15,2,,251
1497,DCHårsmøde2016,3,3,,1,3,3,,6
1498,it.,7,3,,2,4,2,,10
1499,https://t.co/bJyjYH7Rs2,3,3,,1,3,3,,6
1500,Omlæg,3,2,,1,3,2,,5
1501,https://t.co/AFlxfhLGH6,3,2,,1,3,2,,5
1502,arbejdsmarkedspolitik,13,1,,1,13,1,,14
1503,fattigdomsreformer,13,1,,1,13,1,,14
1504,modstandsbevægelse,13,1,,1,13,1,,14
1505,fleksjob,13,1,,1,13,1,,14
1506,Loftet,13,1,,1,13,1,,14
1507,elendighed,46,1,,3,15,0,,47
1508,frakkeeeeee,18,2,,1,18,2,,20
1509,tøj,153,20,,5,31,4,,173
1510,ubrugt,52,9,,2,26,4,,61
1511,Greenfriday,18,2,,1,18,2,,20
1512,DerforUffe,18,2,,1,18,2,,20
1513,https://t.co/xrsr9bQ7ry,18,2,,1,18,2,,20
1514,Sandheden,165,27,,4,41,7,,192
1515,modkrav-forsøg,97,9,,1,97,9,,106
1516,Fin,110,17,,3,37,6,,127
1517,sanktion,205,33,,4,51,8,,238
1518,Besøg,3,3,,1,3,3,,6
1519,AAU,3,3,,1,3,3,,6
1520,Rektor,3,3,,1,3,3,,6
1521,Universitet,3,3,,1,3,3,,6
1522,tværvidenskab,3,3,,1,3,3,,6
1523,monofaglige,3,3,,1,3,3,,6
1524,forsker,93,21,,5,19,4,,114
1525,k.loftet,1,1,,1,1,1,,2
1526,kvinde,5772,380,,50,115,8,,6152
1527,samfund-mindre,7,1,,1,7,1,,8
1528,off.nedskæringer,7,1,,1,7,1,,8
1529,magt,1364,126,,23,59,5,,1490
1530,https://t.co/KZjat7MqQ9,7,1,,1,7,1,,8
1531,Regeringens,180,66,,11,16,6,,246
1532,retorik,1589,142,,8,199,18,,1731
1533,ledighed,14,11,,2,7,6,,25
1534,lediges,14,11,,1,14,11,,25
1535,Socialdemokraterne,34,10,,6,6,2,,44
1536,klimaflertal,1,0,,1,1,0,,1
1537,pol,41,7,,2,20,4,,48
1538,green,125,26,,5,25,5,,151
1539,http://t.co/Cnsy4KkzpI,1,0,,1,1,0,,1
1540,Besk.min,3,2,,1,3,2,,5
1541,besp,3,2,,1,3,2,,5
1542,boligstøtte,3,2,,1,3,2,,5
1543,https://t.co/hAfz8XwScY,3,2,,1,3,2,,5
1544,krigsveteran,0,0,,1,0,0,,0
1545,gave,439,56,,8,55,7,,495
1546,Frankrig,35,10,,5,7,2,,45
1547,https://t.co/EGMc5c1phW,3,5,,1,3,5,,8
1548,beskæftigelsesudvalg,2,1,,1,2,1,,3
1549,Danske,1480,62,,8,185,8,,1542
1550,pensionsselskab,2,1,,1,2,1,,3
1551,selskab,173,19,,9,19,2,,192
1552,egn,400,40,,21,19,2,,440
1553,målsætning,157,30,,3,52,10,,187
1554,udgangspunkt,15,2,,7,2,0,,17
1555,Parisaftalens,2,1,,1,2,1,,3
1556,temperaturstigning,2,1,,1,2,1,,3
1557,niveau,578,40,,12,48,3,,618
1558,forskellig,99,14,,16,6,1,,113
1559,finansieringsmodel,4,4,,1,4,4,,8
1560,k.hjælp,4,4,,1,4,4,,8
1561,retsproblem,18,14,,1,18,14,,32
1562,timersreglen,18,14,,1,18,14,,32
1563,Halsnæs,18,14,,1,18,14,,32
1564,Norddjurs,18,14,,1,18,14,,32
1565,Kommune,37,15,,2,18,8,,52
1566,https://t.co/CDmP0OtzOd,18,14,,1,18,14,,32
1567,massere,7,3,,6,1,0,,10
1568,klimaproblemerne,0,0,,1,0,0,,0
1569,indrømme,2,0,,2,1,0,,2
1570,hurtig,366,27,,13,28,2,,393
1571,Kom,211,37,,5,42,7,,248
1572,febr.,0,1,,1,0,1,,1
1573,Støt,267,26,,6,44,4,,293
1574,https://t.co/8UwUsj2u24,0,1,,1,0,1,,1
1575,https://t.co/DurGaGiafE,49,13,,1,49,13,,62
1576,luftfartspakken,49,11,,1,49,11,,60
1577,flotte,533,74,,18,30,4,,607
1578,Grøn,314,45,,4,78,11,,359
1579,Genstart,51,12,,2,26,6,,63
1580,erhverv,821,57,,7,117,8,,878
1581,https://t.co/6oUni4hKjL,49,11,,1,49,11,,60
1582,Borgere,16,5,,3,5,2,,21
1583,sagsbehandler,58,12,,2,29,6,,70
1584,chef,180,19,,12,15,2,,199
1585,social-,8,2,,1,8,2,,10
1586,beskæftigelsespolitik,88,11,,2,44,6,,99
1587,Høje-Taastrup,8,2,,1,8,2,,10
1588,tværpolitisk,8,2,,1,8,2,,10
1589,navn,946,73,,10,95,7,,1019
1590,FattigMOD,8,2,,1,8,2,,10
1591,arrangere,8,2,,1,8,2,,10
1592,https://t.co/LJqLOYnLM3,8,2,,1,8,2,,10
1593,fanme,2,0,,1,2,0,,2
1594,klimamarcherne,2,1,,1,2,1,,3
1595,https://t.co/YLH5v5C9Hw,2,1,,1,2,1,,3
1596,Spar,1,0,,1,1,0,,1
1597,CBS,45,5,,3,15,2,,50
1598,spar,1,0,,1,1,0,,1
1599,innovation,1,0,,1,1,0,,1
1600,velstand,60,9,,7,9,1,,69
1601,dkuddpol,54,11,,2,27,6,,65
1602,ældre,563,101,,30,19,3,,664
1603,dagplejeområdet,69,12,,1,69,12,,81
1604,nytænkning,69,12,,1,69,12,,81
1605,beskæftigelsesområde,69,12,,1,69,12,,81
1606,nedværdigelse,69,12,,1,69,12,,81
1607,umyndiggørelse,69,12,,1,69,12,,81
1608,reallønsstigninger,2,0,,1,2,0,,2
1609,BEFOLKNINGEN,98,26,,1,98,26,,124
1610,GÅR,98,26,,1,98,26,,124
1611,LEGALISERE,98,26,,1,98,26,,124
1612,CANNABIS,98,26,,1,98,26,,124
1613,cannabisordfører,98,26,,1,98,26,,124
1614,arm,155,35,,3,52,12,,190
1615,slag,136,32,,2,68,16,,168
1616,Folketingsalen,98,26,,1,98,26,,124
1617,https://www.altinget.dk/artikel/flertal-i-befolkningen-oensker-fri-hash#.XPFVGCsDHFQ.twitter,98,26,,1,98,26,,124
1618,forløb,18,3,,4,4,1,,21
1619,blå,1344,123,,30,45,4,,1467
1620,Frontløbernes,3,0,,1,3,0,,3
1621,socialområde,106,22,,5,21,4,,128
1622,no-cure-no-pay,41,7,,1,41,7,,48
1623,ydelse,773,96,,13,59,7,,869
1624,enmillionstemmer,41,7,,1,41,7,,48
1625,Forslag,3,2,,1,3,2,,5
1626,ompri,3,2,,1,3,2,,5
1627,bidrag,616,67,,8,77,8,,683
1628,livsfornødenhed,41,23,,1,41,23,,64
1629,https://t.co/eQJLZAX1Tp,41,23,,1,41,23,,64
1630,fair,160,14,,14,11,1,,174
1631,Carolina,8,1,,1,8,1,,9
1632,oplæg,85,14,,4,21,4,,99
1633,Biens,1,0,,1,1,0,,1
1634,borgerløns,1,0,,1,1,0,,1
1635,størrelse,1,0,,1,1,0,,1
1636,erstatte,1,0,,1,1,0,,1
1637,andel,65,7,,5,13,1,,72
1638,pct.,84,12,,6,14,2,,96
1639,Dagpengemodtagere,1,0,,1,1,0,,1
1640,forsikringsdel,1,0,,1,1,0,,1
1641,presse,705,126,,25,28,5,,831
1642,Twitterprofil,62,2,,2,31,1,,64
1643,kommissionsundersøgelse,43,14,,3,14,5,,57
1644,minksagen,313,6,,2,156,3,,319
1645,beklagelse,0,0,,1,0,0,,0
1646,Neergaard,27,15,,1,27,15,,42
1647,https://t.co/lOAYwlF88P,27,15,,1,27,15,,42
1648,Arrangeret,1,0,,1,1,0,,1
1649,Højskolebladet,1,0,,1,1,0,,1
1650,http://t.co/WcSisTIe4b,1,0,,1,1,0,,1
1651,interesse,297,54,,7,42,8,,351
1652,mekanisme,3,0,,2,2,0,,3
1653,kassetænkning,3,0,,1,3,0,,3
1654,k.hjælpsloftet,15,14,,1,15,14,,29
1655,out,61,25,,3,20,8,,86
1656,Klar,522,61,,13,40,5,,583
1657,sprg,2,0,,1,2,0,,2
1658,Uddannelsesministeren,2,0,,1,2,0,,2
1659,fremdriftsreformen,5,0,,3,2,0,,5
1660,palestinemarathon,12,3,,1,12,3,,15
1661,mærkelig,1758,96,,12,146,8,,1854
1662,Syge+danskere+i+sengepraktik+|+TV+|+DR,1,0,,1,1,0,,1
1663,https://t.co/saLuF93B7s,1,0,,1,1,0,,1
1664,Smugkig,37,6,,1,37,6,,43
1665,afslutningsdebat,933,28,,3,311,9,,961
1666,længselsparti,37,6,,1,37,6,,43
1667,Frihed,188,27,,4,47,7,,215
1668,ansvar,1845,264,,55,34,5,,2109
1669,region,128,33,,6,21,6,,161
1670,civil,65,11,,2,32,6,,76
1671,https://t.co/4wHAEBV8bg,14,6,,1,14,6,,20
1672,Thomas,26,8,,6,4,1,,34
1673,forligsparti,3,4,,2,2,2,,7
1674,hyld,2,1,,2,1,0,,3
1675,Hej,582,51,,21,28,2,,633
1676,efterår,61,34,,5,12,7,,95
1677,afskaffe,30,8,,3,10,3,,38
1678,firkantet,22,1,,3,7,0,,23
1679,twittter,0,0,,1,0,0,,0
1680,definition,172,21,,4,43,5,,193
1681,betingelsesløs,0,0,,1,0,0,,0
1682,bevidsthed,13,2,,2,6,1,,15
1683,miljø,340,55,,14,24,4,,395
1684,kapitalophobning,0,0,,1,0,0,,0
1685,folkemøde,2,4,,1,2,4,,6
1686,Tillidsvotum,9,7,,1,9,7,,16
1687,befolkning,1058,104,,19,56,5,,1162
1688,Kontrol,9,7,,1,9,7,,16
1689,https://t.co/a3s7DW8M6b,9,7,,1,9,7,,16
1690,medarbejder,682,33,,15,45,2,,715
1691,skridt,1280,160,,25,51,6,,1440
1692,tung,2,0,,1,2,0,,2
1693,relationsvelfærd,16,4,,1,16,4,,20
1694,Askovfonden,16,4,,1,16,4,,20
1695,https://t.co/WasFTNZzyg,16,4,,1,16,4,,20
1696,Coronaen,31,8,,2,16,4,,39
1697,muslimsk,236,51,,15,16,3,,287
1698,kreds,262,28,,3,87,9,,290
1699,COVID19dk,307,56,,7,44,8,,363
1700,Kulturnatten,12,3,,1,12,3,,15
1701,12.,16,6,,2,8,3,,22
1702,eventyrlig,24,6,,2,12,3,,30
1703,Folkeparti,1710,94,,12,142,8,,1804
1704,folkevalgt,65,15,,6,11,2,,80
1705,figur,12,3,,1,12,3,,15
1706,hcandersenparaden,12,3,,1,12,3,,15
1707,kimsjøgren,12,3,,1,12,3,,15
1708,vidunderbarn,12,3,,1,12,3,,15
1709,underholde,12,3,,1,12,3,,15
1710,https://t.co/Olm2JxPwv7,12,3,,1,12,3,,15
1711,ligemåde,2,0,,2,1,0,,2
1712,Vildt,54,9,,3,18,3,,63
1713,https://t.co/KIixxcXO3,8,1,,1,8,1,,9
1714,udlændingeministeren,54,10,,1,54,10,,64
1715,kriminel,589,107,,25,24,4,,696
1716,udlænding,1247,205,,29,43,7,,1452
1717,Kærshovedgaard,54,10,,1,54,10,,64
1718,erhvervspraktik,54,10,,1,54,10,,64
1719,Absurd,265,47,,5,53,9,,312
1720,Kl.,109,16,,2,54,8,,125
1721,15.,178,20,,3,59,7,,198
1722,person,580,41,,14,41,3,,621
1723,retur,216,2,,2,108,1,,218
1724,Afganistan,2,0,,1,2,0,,2
1725,Usmageligt,34,8,,1,34,8,,42
1726,overdrage,34,8,,1,34,8,,42
1727,folkekirke,34,8,,1,34,8,,42
1728,Birgitte,34,8,,1,34,8,,42
1729,kvart,34,8,,1,34,8,,42
1730,trist,1703,84,,21,81,4,,1787
1731,afstumpe,21,2,,1,21,2,,23
1732,stjæle,21,2,,1,21,2,,23
1733,smuk,1271,59,,13,98,5,,1330
1734,alterstager,21,2,,1,21,2,,23
1735,Frue,21,2,,1,21,2,,23
1736,Kirke,21,2,,1,21,2,,23
1737,dusør,21,2,,1,21,2,,23
1738,stage,21,2,,1,21,2,,23
1739,kulturarv,111,7,,3,37,2,,118
1740,urolig,21,2,,1,21,2,,23
1741,https://t.co/4dwFDzaZQv,21,2,,1,21,2,,23
1742,bevis,75,11,,4,19,3,,86
1743,svenske,126,21,,6,21,4,,147
1744,medium,1719,146,,25,69,6,,1865
1745,sær,93,3,,2,46,2,,96
1746,eksistens,5,0,,1,5,0,,5
1747,skøre,5,0,,1,5,0,,5
1748,kugle,30,4,,2,15,2,,34
1749,Mads,145,21,,7,21,3,,166
1750,emne,188,34,,7,27,5,,222
1751,muslim,787,59,,12,66,5,,846
1752,ulv,36,5,,3,12,2,,41
1753,Koranen,40,12,,2,20,6,,52
1754,niqaben,4,1,,1,4,1,,5
1755,obligatorisk,47,8,,2,24,4,,55
1756,Taher,4,1,,1,4,1,,5
1757,Toujgani,4,1,,1,4,1,,5
1758,retslærd,4,1,,1,4,1,,5
1759,https://t.co/NrmOTWfGu4,4,1,,1,4,1,,5
1760,Glædeligt,156,24,,3,52,8,,180
1761,Grækenland,250,39,,3,83,13,,289
1762,grænse,522,126,,26,20,5,,648
1763,migranterne,106,24,,2,53,12,,130
1764,Resten,178,26,,4,44,6,,204
1765,troppe,81,16,,1,81,16,,97
1766,potentiel,253,45,,6,42,8,,298
1767,grænseoverløber,81,16,,1,81,16,,97
1768,held,98,21,,3,33,7,,119
1769,forbrydelse,329,47,,7,47,7,,376
1770,https://t.co/QF2D5nceG2,81,16,,1,81,16,,97
1771,bestemmelse,64,7,,2,32,4,,71
1772,foranstaltning,18,2,,1,18,2,,20
1773,opretholdelse,18,2,,1,18,2,,20
1774,https://t.co/2fPlBkb0VW,5,1,,1,5,1,,6
1775,forbindelse,234,40,,13,18,3,,274
1776,dansk-forbundne,55,7,,1,55,7,,62
1777,Islamisk,440,50,,7,63,7,,490
1778,Stat-krigere,55,7,,1,55,7,,62
1779,DFs,133,27,,7,19,4,,160
1780,IS-krigere,93,11,,2,46,6,,104
1781,terrordømte,55,7,,1,55,7,,62
1782,livstid,55,7,,1,55,7,,62
1783,https://t.co/D6WhHzVVgu,55,7,,1,55,7,,62
1784,Statsministeren,2242,223,,15,149,15,,2465
1785,Rigsretssag,121,17,,1,121,17,,138
1786,Granskningskommissionen,121,17,,1,121,17,,138
1787,NokErNok,146,23,,2,73,12,,169
1788,https://t.co/DTzLjZ7knb,121,17,,1,121,17,,138
1789,ældreområde,88,20,,5,18,4,,108
1790,ældrelov,4,3,,1,4,3,,7
1791,standard,551,29,,4,138,7,,580
1792,omsorg,162,27,,6,27,4,,189
1793,klippekortsordningen,4,3,,1,4,3,,7
1794,fremsætte,5,3,,2,2,2,,8
1795,https://t.co/HYLZ24Z632,4,3,,1,4,3,,7
1796,Tudekiks,5,1,,1,5,1,,6
1797,Vinterberg,5,1,,1,5,1,,6
1798,flove,5,1,,1,5,1,,6
1799,hjemland,113,27,,3,38,9,,140
1800,spillefilm,5,1,,1,5,1,,6
1801,skuespil,5,1,,1,5,1,,6
1802,medlemsland,41,12,,1,41,12,,53
1803,Østeuropa,96,25,,2,48,12,,121
1804,medfinansiere,41,12,,1,41,12,,53
1805,veto,42,12,,2,21,6,,54
1806,seniorførtidspension,28,8,,2,14,4,,36
1807,respektløs,83,17,,1,83,17,,100
1808,Demokratiet,83,17,,1,83,17,,100
1809,vilkår,277,35,,13,21,3,,312
1810,Enhedslisten,975,125,,26,38,5,,1100
1811,https://t.co/WQkdY3szFA,83,17,,1,83,17,,100
1812,Spørgelysten,18,3,,1,18,3,,21
1813,pressemøde,320,33,,7,46,5,,353
1814,tradition,58,11,,3,19,4,,69
1815,tro,148,35,,6,25,6,,183
1816,Sommergruppemøde,18,3,,1,18,3,,21
1817,Sønderborg,40,6,,4,10,2,,46
1818,FL19,63,9,,4,16,2,,72
1819,https://t.co/J7Ph5KfaSj,18,3,,1,18,3,,21
1820,rolle,122,48,,6,20,8,,170
1821,minkskandalen,29,7,,2,14,4,,36
1822,https://t.co/8IqIeum4Vy,2,1,,1,2,1,,3
1823,Alle,778,105,,31,25,3,,883
1824,kødafgift,5,1,,1,5,1,,6
1825,kr.,1446,210,,32,45,7,,1656
1826,https://t.co/pMIr8dhVe9,5,1,,1,5,1,,6
1827,ftlive,431,78,,26,17,3,,509
1828,Skøn,21,1,,2,10,0,,22
1829,julekoncert,10,0,,1,10,0,,10
1830,Holmens,10,0,,1,10,0,,10
1831,kirke,114,14,,3,38,5,,128
1832,musik,28,2,,5,6,0,,30
1833,festlig,10,0,,1,10,0,,10
1834,følelse,83,15,,9,9,2,,98
1835,udmarch-musik,10,0,,1,10,0,,10
1836,våbenhus,10,0,,1,10,0,,10
1837,småsnakke,10,0,,1,10,0,,10
1838,pinlig,259,58,,9,29,6,,317
1839,stilhed,10,0,,1,10,0,,10
1840,https://t.co/73l5W9zZNA,10,0,,1,10,0,,10
1841,Årh,3,0,,1,3,0,,3
1842,kede,117,13,,4,29,3,,130
1843,forkæmper,3,0,,1,3,0,,3
1844,klimamål,98,18,,3,33,6,,116
1845,procent,624,68,,15,42,5,,692
1846,https://t.co/Ru2FbPOgwT,50,8,,1,50,8,,58
1847,Trist,324,49,,8,40,6,,373
1848,påske,146,21,,4,36,5,,167
1849,svær,878,71,,12,73,6,,949
1850,brug,3790,553,,90,42,6,,4343
1851,samhørighed,115,21,,3,38,7,,136
1852,tilværelse,62,10,,2,31,5,,72
1853,kristen,137,25,,6,23,4,,162
1854,prædike,119,17,,2,60,8,,136
1855,online,82,15,,4,20,4,,97
1856,corona-regler,61,10,,1,61,10,,71
1857,andagt,61,10,,1,61,10,,71
1858,gudstjeneste,61,10,,1,61,10,,71
1859,Skandale,0,0,,1,0,0,,0
1860,Babington,0,0,,1,0,0,,0
1861,Socialdemokratiet,412,77,,20,21,4,,489
1862,valgkamp,819,74,,13,63,6,,893
1863,svinestreg,12,2,,1,12,2,,14
1864,https://t.co/Pz1AFQAXqP,12,2,,1,12,2,,14
1865,læsning,48,5,,6,8,1,,53
1866,friske,330,25,,8,41,3,,355
1867,bæst,11,1,,1,11,1,,12
1868,Sibirien,12,2,,2,6,1,,14
1869,jæger,11,1,,1,11,1,,12
1870,Blog,11,1,,1,11,1,,12
1871,blodtørstig,11,1,,1,11,1,,12
1872,hjemmepleje,2,0,,1,2,0,,2
1873,HURRA,74,16,,1,74,16,,90
1874,BREXIT,74,16,,1,74,16,,90
1875,DEXIT,74,16,,1,74,16,,90
1876,HVORNÅR,74,16,,1,74,16,,90
1877,https://t.co/2pdbOBcyQP,74,16,,1,74,16,,90
1878,gear,38,6,,1,38,6,,44
1879,Vigtigt,845,106,,19,44,6,,951
1880,Tiden,38,6,,1,38,6,,44
1881,eksperiment,38,6,,2,19,3,,44
1882,fl20,361,45,,7,52,6,,406
1883,stille,371,48,,7,53,7,,419
1884,dørerne,0,0,,1,0,0,,0
1885,Nyhavns,62,8,,1,62,8,,70
1886,kold,177,23,,6,30,4,,200
1887,vand,211,27,,5,42,5,,238
1888,syvårig,62,8,,1,62,8,,70
1889,https://t.co/iOJbL2KCEs,62,8,,1,62,8,,70
1890,Fornuftig,21,4,,1,21,4,,25
1891,politiaftale,272,21,,3,91,7,,293
1892,DF-aftryk,21,4,,1,21,4,,25
1893,politi,1882,212,,36,52,6,,2094
1894,https://t.co/YVcdZ0ez9o,25,6,,1,25,6,,31
1895,https://t.co/Q2gg291RsF,8,3,,1,8,3,,11
1896,stemdf,0,0,,1,0,0,,0
1897,https://t.co/RuWcUqIBeH,0,0,,1,0,0,,0
1898,Netanyahu,13,1,,1,13,1,,14
1899,Jordan-Dalen,13,1,,1,13,1,,14
1900,række,436,62,,15,29,4,,498
1901,israelsk,58,11,,3,19,4,,69
1902,Vestbredden,13,1,,1,13,1,,14
1903,https://t.co/SZdLlHVmZ8,13,1,,1,13,1,,14
1904,usympatisk,150,15,,1,150,15,,165
1905,Facebook-opslag,150,15,,1,150,15,,165
1906,Dronningens,150,15,,1,150,15,,165
1907,respekt,920,67,,23,40,3,,987
1908,ven,578,59,,23,25,3,,637
1909,Færre,65,14,,4,16,4,,79
1910,østeuropæere,55,13,,1,55,13,,68
1911,levevilkår,55,13,,1,55,13,,68
1912,negativ,227,38,,6,38,6,,265
1913,aldeles,111,18,,1,111,18,,129
1914,vildt,350,40,,11,32,4,,390
1915,USA,1203,150,,22,55,7,,1353
1916,Imam-diktaturet,111,18,,1,111,18,,129
1917,Teheran,111,18,,1,111,18,,129
1918,ryste,281,46,,5,56,9,,327
1919,svag,199,39,,8,25,5,,238
1920,https://t.co/CXamuc1B0E,111,18,,1,111,18,,129
1921,Dynekongen,6,2,,1,6,2,,8
1922,daw,6,2,,1,6,2,,8
1923,Lars,709,111,,22,32,5,,820
1924,Jysk,6,2,,1,6,2,,8
1925,Sengetøjslager,6,2,,1,6,2,,8
1926,Æret,184,18,,2,92,9,,202
1927,minde,188,19,,4,47,5,,207
1928,jysk,6,2,,1,6,2,,8
1929,larslarsen,6,2,,1,6,2,,8
1930,https://t.co/fugWt7EuWO,6,2,,1,6,2,,8
1931,https://t.co/aWjVXpM90L,0,0,,1,0,0,,0
1932,spænding,89,12,,3,30,4,,101
1933,Grundlovstale,58,9,,1,58,9,,67
1934,Fedtspiller,58,9,,1,58,9,,67
1935,Ytringsfrihedskommissionen,62,10,,1,62,10,,72
1936,færdig,296,23,,7,42,3,,319
1937,ytringsfrihed,500,86,,9,56,10,,586
1938,årti,425,44,,10,42,4,,469
1939,integration,354,64,,10,35,6,,418
1940,yderlig,50,8,,2,25,4,,58
1941,udlændingestramninger,7,1,,1,7,1,,8
1942,Regan,7,1,,1,7,1,,8
1943,Vest,7,1,,1,7,1,,8
1944,gæst,52,8,,4,13,2,,60
1945,partiformand,77,10,,6,13,2,,87
1946,Kristians,13,0,,1,13,0,,13
1947,jubilæum,162,33,,5,32,7,,195
1948,mia.,1112,147,,19,59,8,,1259
1949,ballade,2,0,,3,1,0,,2
1950,handlingslamme,70,14,,1,70,14,,84
1951,https://t.co/sNuSZUtFGK,70,14,,1,70,14,,84
1952,genåbning,743,96,,12,62,8,,839
1953,.Kirken,40,9,,1,40,9,,49
1954,museum,98,22,,5,20,4,,120
1955,teater,40,9,,1,40,9,,49
1956,biograf,389,35,,4,97,9,,424
1957,andre.#dkpol,40,9,,1,40,9,,49
1958,https://t.co/PBsMkxYV5P,40,9,,1,40,9,,49
1959,grænsekontrol,1019,98,,15,68,7,,1117
1960,grænsestregen,30,4,,1,30,4,,34
1961,https://t.co/i8FSModyxx,7,2,,1,7,2,,9
1962,reg's,5,3,,1,5,3,,8
1963,lovforslag,300,45,,10,30,4,,345
1964,nejtak,5,3,,1,5,3,,8
1965,http://t.co/V0Ga1q95Ta,5,3,,1,5,3,,8
1966,afgøre,610,51,,24,25,2,,661
1967,rigspoliti,109,16,,2,54,8,,125
1968,forståelse,1069,128,,6,178,21,,1197
1969,minkejere,4,4,,1,4,4,,8
1970,lovgrundlag,15,5,,2,8,2,,20
1971,pil,5,6,,2,2,3,,11
1972,justitsministerium,4,4,,1,4,4,,8
1973,https://t.co/NA4ObOEOOG,10,0,,1,10,0,,10
1974,Åbenlys,3,1,,1,3,1,,4
1975,Socialdemokraternes,3,1,,1,3,1,,4
1976,møgsag,3,1,,1,3,1,,4
1977,Frank,27,5,,4,7,1,,32
1978,https://t.co/tgk2MZ5j20,3,1,,1,3,1,,4
1979,Politisk,56,10,,2,28,5,,66
1980,korrekthed,102,25,,3,34,8,,127
1981,absurd,333,64,,10,33,6,,397
1982,Suk,203,22,,3,68,7,,225
1983,https://t.co/g6pkM7xTyn,44,10,,1,44,10,,54
1984,turismeindustri,0,0,,1,0,0,,0
1985,vesterhavsyd,0,0,,1,0,0,,0
1986,DKs,34,16,,4,8,4,,50
1987,turismeområder,0,0,,1,0,0,,0
1988,illegal,87,24,,5,17,5,,111
1989,indvandrer,536,80,,17,32,5,,616
1990,Illegale,3,0,,1,3,0,,3
1991,https://t.co/aOtNHBXG55,3,0,,1,3,0,,3
1992,tidspunkt,59,11,,6,10,2,,70
1993,modvilje,0,0,,1,0,0,,0
1994,Østrig,81,11,,2,40,6,,92
1995,https://t.co/QgvPtBl7wb,9,1,,1,9,1,,10
1996,http://t.co/uIttfGgJfi,2,1,,1,2,1,,3
1997,voldtægt,357,44,,7,51,6,,401
1998,skyderi,51,5,,3,17,2,,56
1999,kriminalitet,409,62,,10,41,6,,471
2000,Amager,2,0,,2,1,0,,2
2001,https://t.co/4LBRK2xAef,0,0,,1,0,0,,0
2002,Jarlov,46,2,,4,12,0,,48
2003,Marie,229,48,,5,46,10,,277
2004,Krarup,57,13,,3,19,4,,70
2005,Putin,69,35,,6,12,6,,104
2006,Kold,3,1,,1,3,1,,4
2007,Krig,8,2,,2,4,1,,10
2008,trussel,714,95,,18,40,5,,809
2009,https://t.co/YllSpYtqWB,3,1,,1,3,1,,4
2010,Godt,354,39,,15,24,3,,393
2011,anklagemyndighed,69,17,,3,23,6,,86
2012,streng,72,15,,2,36,8,,87
2013,straf,291,48,,8,36,6,,339
2014,drabsforsøg,62,15,,1,62,15,,77
2015,statsborger,261,46,,10,26,5,,307
2016,politidk,62,15,,1,62,15,,77
2017,dkkrim,141,32,,4,35,8,,173
2018,https://t.co/Lgr91qjv0U,62,15,,1,62,15,,77
2019,bil,313,57,,25,13,2,,370
2020,sikkerhed,308,70,,10,31,7,,378
2021,Udemærket,43,13,,1,43,13,,56
2022,kompromisse,43,13,,1,43,13,,56
2023,https://t.co/AjQD8I71lo,43,13,,1,43,13,,56
2024,professor,315,59,,5,63,12,,374
2025,Folkepartis,258,32,,3,86,11,,290
2026,Mærkeligt,26,7,,1,26,7,,33
2027,https://t.co/kd3ffbcpBo,26,7,,1,26,7,,33
2028,Lille,53,13,,3,18,4,,66
2029,Vildmose,1,1,,1,1,1,,2
2030,fremvise,1,1,,1,1,1,,2
2031,besked,30,8,,4,8,2,,38
2032,lodsejer,1,1,,1,1,1,,2
2033,bank,1050,140,,14,75,10,,1190
2034,grundig,68,6,,4,17,2,,74
2035,balance,544,91,,18,30,5,,635
2036,adskillig,55,9,,3,18,3,,64
2037,henvendelse,0,0,,1,0,0,,0
2038,bruger,9,1,,4,2,0,,10
2039,Tillykke,560,47,,32,18,1,,607
2040,post,603,21,,5,121,4,,624
2041,GRØN,4,1,,1,4,1,,5
2042,TUBORG,4,1,,1,4,1,,5
2043,Hjemmeværnet,24,10,,1,24,10,,34
2044,Politikadetterne,24,10,,1,24,10,,34
2045,Forsvaret,116,17,,4,29,4,,133
2046,ært,24,10,,1,24,10,,34
2047,Politiet,195,50,,7,28,7,,245
2048,Sikker,38,10,,2,19,5,,48
2049,lykkelig,56,10,,2,28,5,,66
2050,grænseindsats,24,10,,1,24,10,,34
2051,mandskabsmangel,24,10,,1,24,10,,34
2052,https://t.co/PgenOdeSwn,24,10,,1,24,10,,34
2053,http://t.co/sRU97BG9BS,0,0,,1,0,0,,0
2054,fordom,25,7,,3,8,2,,32
2055,Rusland,18,5,,7,3,1,,23
2056,Journalister,55,8,,2,28,4,,63
2057,fælles,1063,119,,31,34,4,,1182
2058,selvmord,11,4,,2,6,2,,15
2059,stime,7,3,,1,7,3,,10
2060,https://t.co/P4cPhfd4aA,7,3,,1,7,3,,10
2061,socialudgift,49,17,,1,49,17,,66
2062,mio.,260,54,,13,20,4,,314
2063,statsfinansieret,49,17,,1,49,17,,66
2064,lønforhøjelse,54,17,,4,14,4,,71
2065,naiv,148,29,,6,25,5,,177
2066,eklatant,49,17,,1,49,17,,66
2067,løftebrud,103,40,,4,26,10,,143
2068,Socialdem,49,17,,1,49,17,,66
2069,Debatten,141,8,,8,18,1,,149
2070,Radio,400,23,,7,57,3,,423
2071,24syv,57,6,,2,28,3,,63
2072,https://t.co/oaeiG8Szpl,9,1,,1,9,1,,10
2073,Glædelig,162,10,,6,27,2,,172
2074,Jul,24,4,,1,24,4,,28
2075,mus,24,4,,1,24,4,,28
2076,https://t.co/hXDoOSLKt6,24,4,,1,24,4,,28
2077,Held,245,30,,3,82,10,,275
2078,journalistspirer,115,11,,1,115,11,,126
2079,EU's,184,26,,4,46,6,,210
2080,leder,144,15,,6,24,2,,159
2081,panikdag,115,11,,1,115,11,,126
2082,traditionstweet,115,11,,1,115,11,,126
2083,tilbageigen,115,11,,1,115,11,,126
2084,Politiko,5,0,,1,5,0,,5
2085,https://t.co/LYBAktaGXV,5,0,,1,5,0,,5
2086,Sverige,409,87,,15,27,6,,496
2087,Centerpartiet,21,5,,1,21,5,,26
2088,Löfven,25,5,,2,12,2,,30
2089,Sverigedemokraterne,21,5,,1,21,5,,26
2090,https://t.co/EgSf70A2vF,0,0,,1,0,0,,0
2091,Spændende,249,35,,13,19,3,,284
2092,besøg,692,95,,24,29,4,,787
2093,Portland,9,0,,1,9,0,,9
2094,FT-gruppen,9,0,,1,9,0,,9
2095,sommergruppemødet,9,0,,1,9,0,,9
2096,Udsigten,9,0,,1,9,0,,9
2097,https://t.co/jMs0lOrnlm,9,0,,1,9,0,,9
2098,Sounds,0,0,,1,0,0,,0
2099,intetesting,0,0,,1,0,0,,0
2100,Where,0,0,,1,0,0,,0
2101,Can,0,0,,1,0,0,,0
2102,about,21,17,,2,10,8,,38
2103,That,1,0,,2,0,0,,1
2104,herre,673,37,,3,224,12,,710
2105,hest,821,45,,5,164,9,,866
2106,menneskehandel,1,2,,1,1,2,,3
2107,yder,1,2,,1,1,2,,3
2108,komme,1,2,,1,1,2,,3
2109,https://t.co/l9PkqOWreh,1,2,,1,1,2,,3
2110,https://t.co/udIbHmIO36,0,0,,1,0,0,,0
2111,forklaring,375,71,,7,54,10,,446
2112,statist,113,23,,1,113,23,,136
2113,S-regeringens,113,23,,2,56,12,,136
2114,https://t.co/MtEVOlkFq9,113,23,,1,113,23,,136
2115,stemningsfuld,19,2,,1,19,2,,21
2116,foto,26,2,,2,13,1,,28
2117,https://t.co/Y1L67La6lF,19,2,,1,19,2,,21
2118,port,98,12,,1,98,12,,110
2119,modig,139,20,,3,46,7,,159
2120,politifolk,98,12,,1,98,12,,110
2121,https://t.co/h9OSGros5,98,12,,1,98,12,,110
2122,Nedenstående,4,0,,1,4,0,,4
2123,tolerance,38,8,,2,19,4,,46
2124,tolerant,4,0,,1,4,0,,4
2125,folkefærd,4,0,,1,4,0,,4
2126,https://t.co/HH3wieNT0U,4,0,,1,4,0,,4
2127,talerør,1,0,,1,1,0,,1
2128,dreng,319,33,,11,29,3,,352
2129,forstand,33,5,,2,16,2,,38
2130,stramme,170,31,,6,28,5,,201
2131,tøjle,33,5,,1,33,5,,38
2132,KTD,300,14,,2,150,7,,314
2133,bekymring,133,22,,8,17,3,,155
2134,fravalg,5,1,,1,5,1,,6
2135,Inger,94,12,,5,19,2,,106
2136,linje,52,1,,5,10,0,,53
2137,https://t.co/yOm7rQPVYT,0,0,,1,0,0,,0
2138,https://t.co/VsgjcRXLeh,0,0,,1,0,0,,0
2139,Clever,23,2,,1,23,2,,25
2140,tredobling,23,2,,1,23,2,,25
2141,ladestandere,23,2,,1,23,2,,25
2142,el-bilister,23,2,,1,23,2,,25
2143,fremsyn,23,2,,1,23,2,,25
2144,dkenergi,78,31,,12,6,3,,109
2145,https://t.co/x0zCtvrmLt,23,2,,1,23,2,,25
2146,run,3,0,,1,3,0,,3
2147,Katjes,10,4,,1,10,4,,14
2148,moderne,275,30,,4,69,8,,305
2149,Øhh,11,4,,2,6,2,,15
2150,middelalderlig,10,4,,1,10,4,,14
2151,evig,103,12,,3,34,4,,115
2152,lefle,10,4,,2,5,2,,14
2153,Hovedparten,14,4,,2,7,2,,18
2154,nordjysk,28,10,,2,14,5,,38
2155,landmand,105,12,,4,26,3,,117
2156,støj,1,0,,2,0,0,,1
2157,https://t.co/IDS9xgQpTH,1,0,,1,1,0,,1
2158,immunologi,115,19,,1,115,19,,134
2159,smågrine,115,19,,1,115,19,,134
2160,optræde,128,21,,2,64,10,,149
2161,speciel,115,19,,1,115,19,,134
2162,dragt,115,19,,1,115,19,,134
2163,https://t.co/6OHPUxz3at,115,19,,1,115,19,,134
2164,DR1,132,17,,4,33,4,,149
2165,STU,26,4,,1,26,4,,30
2166,potential,26,4,,1,26,4,,30
2167,fremtidsplan,26,4,,1,26,4,,30
2168,opstrammer,26,4,,1,26,4,,30
2169,langsomt.#dkpol,26,4,,1,26,4,,30
2170,vanvittig,309,42,,8,39,5,,351
2171,https://t.co/Xb38q7siHt,139,14,,1,139,14,,153
2172,statsmin,16,4,,1,16,4,,20
2173,indvandring,16,4,,3,5,1,,20
2174,asyltilstrømningen,16,4,,1,16,4,,20
2175,Gad,90,18,,4,22,4,,108
2176,http://t.co/N1palKaxo0,13,12,,1,13,12,,25
2177,Taiwan,33,18,,2,16,9,,51
2178,pandaanlægget,12,1,,1,12,1,,13
2179,Zoo,12,1,,2,6,0,,13
2180,kinesisk,19,3,,3,6,1,,22
2181,delegation,64,10,,4,16,2,,74
2182,Esp,12,1,,1,12,1,,13
2183,https://t.co/HdTgNTlDYP,12,1,,1,12,1,,13
2184,Regningerne,2,1,,1,2,1,,3
2185,måned,373,72,,16,23,4,,445
2186,ventetid,37,2,,2,18,1,,39
2187,banal,5,1,,1,5,1,,6
2188,regeringsparti,6,1,,2,3,0,,7
2189,FL18,5,1,,1,5,1,,6
2190,https://t.co/9hPK7QdCLO,5,1,,1,5,1,,6
2191,Morten,1065,136,,15,71,9,,1201
2192,opdatering,4,3,,2,2,2,,7
2193,https://t.co/6rDnGY2sG8,1,0,,1,1,0,,1
2194,Dannebrogs,11,1,,1,11,1,,12
2195,oplægge,196,22,,9,22,2,,218
2196,landsforræder,49,5,,2,24,2,,54
2197,Leonora,11,1,,1,11,1,,12
2198,Kristine,11,1,,1,11,1,,12
2199,https://t.co/vhAvQos1Cf,11,1,,1,11,1,,12
2200,råd,986,121,,23,43,5,,1107
2201,https://t.co/JO3FdHyYTR,107,19,,1,107,19,,126
2202,folketingsmedlem,675,50,,2,338,25,,725
2203,liste,132,19,,4,33,5,,151
2204,Ynkeligt,34,0,,1,34,0,,34
2205,FV19,598,47,,5,120,9,,645
2206,udgive,34,0,,1,34,0,,34
2207,realitetssans,34,0,,1,34,0,,34
2208,KOM,47,2,,2,24,1,,49
2209,DIG,53,2,,2,26,1,,55
2210,PRINCIPPER,34,0,,1,34,0,,34
2211,elendig,98,14,,3,33,5,,112
2212,12-skala,66,14,,1,66,14,,80
2213,indbrudstyv,4,1,,1,4,1,,5
2214,stund,8,1,,3,3,0,,9
2215,;-),14,6,,4,4,2,,20
2216,Sikring,4,1,,1,4,1,,5
2217,hovedansvar,3,2,,1,3,2,,5
2218,eu-østaftale,3,2,,1,3,2,,5
2219,østarbejdere,3,2,,1,3,2,,5
2220,naturlig,89,19,,5,18,4,,108
2221,konsekvens,516,74,,24,22,3,,590
2222,http://t.co/U9BiGUiGBk,3,2,,1,3,2,,5
2223,eudk,1105,197,,25,44,8,,1302
2224,Talepapirerne,2,1,,1,2,1,,3
2225,DronningensNytårstale,2,1,,1,2,1,,3
2226,Efterlysning,6,4,,1,6,4,,10
2227,finanslovsudspil,22,5,,2,11,2,,27
2228,https://t.co/U86GEg9JR7,6,4,,1,6,4,,10
2229,fin,312,22,,11,28,2,,334
2230,hensigtserklæring,37,6,,1,37,6,,43
2231,regeringsaftale,45,7,,2,22,4,,52
2232,sand,286,34,,7,41,5,,320
2233,anvisning,37,6,,1,37,6,,43
2234,portræt,39,5,,2,20,2,,44
2235,Dronningen.,20,4,,1,20,4,,24
2236,fredag,154,19,,7,22,3,,173
2237,Mikael,65,13,,5,13,3,,78
2238,Melbye,37,6,,2,18,3,,43
2239,formandsportræt,20,4,,1,20,4,,24
2240,Samtaleværelset,20,4,,1,20,4,,24
2241,hykle,1,2,,1,1,2,,3
2242,Astrid,333,26,,3,111,9,,359
2243,Kragh,1,2,,1,1,2,,3
2244,Dong,1,2,,1,1,2,,3
2245,mørklægning,1,2,,1,1,2,,3
2246,off.hedsloven,1,2,,1,1,2,,3
2247,m.m.,2,2,,3,1,1,,4
2248,turistbranche,18,4,,1,18,4,,22
2249,tætte,81,16,,4,20,4,,97
2250,Skønne,88,8,,1,88,8,,96
2251,️#dkpol,363,35,,5,73,7,,398
2252,https://t.co/ddtnDEt9e7,88,8,,1,88,8,,96
2253,Kristian,414,48,,8,52,6,,462
2254,Thulesen,387,35,,7,55,5,,422
2255,Dahl,389,35,,8,49,4,,424
2256,TV2,447,92,,10,45,9,,539
2257,News,47,16,,3,16,5,,63
2258,Altingets,19,7,,1,19,7,,26
2259,Sommermøde,19,7,,1,19,7,,26
2260,løbe,3,0,,1,3,0,,3
2261,Thorning,214,20,,6,36,3,,234
2262,pressefrihed,6,2,,2,3,1,,8
2263,offentlighedslov,35,5,,3,12,2,,40
2264,http://t.co/J12FchIIAd,3,1,,1,3,1,,4
2265,kongehus,204,21,,2,102,10,,225
2266,smil,59,4,,4,15,1,,63
2267,tåre,17,1,,3,6,0,,18
2268,grin,398,4,,3,133,1,,402
2269,program,48,11,,10,5,1,,59
2270,Radio24syv,53,9,,2,26,4,,62
2271,streg,50,9,,2,25,4,,59
2272,lyve,49,9,,1,49,9,,58
2273,dødsfald,60,12,,2,30,6,,72
2274,Pia,133,33,,10,13,3,,166
2275,Adelsteen,49,9,,1,49,9,,58
2276,https://t.co/bgdDU3zBU4,49,9,,1,49,9,,58
2277,Afslutning,12,9,,1,12,9,,21
2278,sommergruppemøde,57,12,,3,19,4,,69
2279,https://t.co/eU7sqN6Sdk,12,9,,1,12,9,,21
2280,https://t.co/Liwl8S8S73,1,0,,1,1,0,,1
2281,hør,56,3,,2,28,2,,59
2282,æter,45,3,,1,45,3,,48
2283,dkkulttur,45,3,,1,45,3,,48
2284,https://t.co/M4pqxwGmtx,45,3,,1,45,3,,48
2285,håbløs,258,51,,4,64,13,,309
2286,beskyttelse,121,20,,3,40,7,,141
2287,dygtig,402,61,,11,37,6,,463
2288,sundhedsvæsen,2173,226,,18,121,13,,2399
2289,kollega,517,61,,15,34,4,,578
2290,læge,368,80,,12,31,7,,448
2291,http://t.co/8hCwp47e2P,2,0,,1,2,0,,2
2292,mdr,887,22,,2,444,11,,909
2293,corona,1951,71,,13,150,5,,2022
2294,sommer,1282,70,,11,117,6,,1352
2295,indhente,886,22,,1,886,22,,908
2296,garanti,165,48,,6,28,8,,213
2297,Radikale,1116,125,,10,112,12,,1241
2298,muskel,75,11,,1,75,11,,86
2299,Folketing,3,0,,2,2,0,,3
2300,Kemiindsats,3,0,,1,3,0,,3
2301,https://t.co/9ESJz5wCxy,3,0,,1,3,0,,3
2302,vindue,111,13,,4,28,3,,124
2303,befrielse,5,1,,2,2,0,,6
2304,tysk,353,59,,10,35,6,,412
2305,besættelsesmagt,4,1,,1,4,1,,5
2306,Verdenskrig,89,25,,2,44,12,,114
2307,weekend,458,66,,17,27,4,,524
2308,https://t.co/vPLgWQiC2x,8,2,,2,4,1,,10
2309,asylstop,81,25,,6,14,4,,106
2310,forøgelse,25,13,,1,25,13,,38
2311,ældrecheck,25,13,,1,25,13,,38
2312,nærområde,83,48,,9,9,5,,131
2313,mio,258,63,,14,18,4,,321
2314,fv19,578,83,,11,53,8,,661
2315,dommenhttp://ekstrabladet.dk/11your,0,1,,1,0,1,,1
2316,new,271,84,,11,25,8,,355
2317,password,0,1,,1,0,1,,1
2318,levakovic-i-retten-her-er-,0,1,,1,0,1,,1
2319,dommen/5675466,0,1,,1,0,1,,1
2320,Jean-Claude,11,3,,1,11,3,,14
2321,EU-kommissionen,11,3,,1,11,3,,14
2322,regeringschef,11,3,,1,11,3,,14
2323,gengæld,582,66,,14,42,5,,648
2324,Behov,46,20,,3,15,7,,66
2325,karakter,137,22,,7,20,3,,159
2326,EU-partierne,6,1,,1,6,1,,7
2327,Europol,38,17,,4,10,4,,55
2328,løftestang,6,1,,1,6,1,,7
2329,retsforbehold,8,4,,2,4,2,,12
2330,parre,421,51,,17,25,3,,472
2331,læk,20,1,,2,10,0,,21
2332,essentiel,0,1,,1,0,1,,1
2333,dårlig,1164,110,,38,31,3,,1274
2334,moral,0,0,,1,0,0,,0
2335,Deadline,74,7,,3,25,2,,81
2336,Trump,880,92,,22,40,4,,972
2337,https://t.co/ZwACnfT0ei,4,0,,1,4,0,,4
2338,ghettotur,51,10,,1,51,10,,61
2339,Skovparken,51,10,,1,51,10,,61
2340,Kolding,165,34,,7,24,5,,199
2341,ghetto,90,22,,3,30,7,,112
2342,stykke,218,27,,8,27,3,,245
2343,julepynt,51,10,,1,51,10,,61
2344,juleting,51,10,,1,51,10,,61
2345,koranindskrifter,51,10,,1,51,10,,61
2346,Italien,241,43,,5,48,9,,284
2347,guldreserver,148,31,,1,148,31,,179
2348,guld,148,31,,1,148,31,,179
2349,Storbritannien,191,35,,2,96,18,,226
2350,italiener,148,31,,1,148,31,,179
2351,skatteyder,612,64,,5,122,13,,676
2352,lom,187,33,,2,94,16,,220
2353,eupol,509,64,,8,64,8,,573
2354,mff,148,31,,1,148,31,,179
2355,https://t.co/4Cxy84nY0A,148,31,,1,148,31,,179
2356,tog,10,7,,7,1,1,,17
2357,https://t.co/ZIWxGRBUKg,2,0,,1,2,0,,2
2358,strand,0,0,,1,0,0,,0
2359,lokal,39,12,,3,13,4,,51
2360,turisme,120,17,,5,24,3,,137
2361,møller,0,0,,1,0,0,,0
2362,Politiken,192,26,,8,24,3,,218
2363,borgerrådgiver,61,10,,1,61,10,,71
2364,Ministerspørgsmål,61,10,,1,61,10,,71
2365,https://t.co/ZVgmhs3Tkx,61,10,,1,61,10,,71
2366,overraskelse,80,15,,5,16,3,,95
2367,Modtog,63,9,,1,63,9,,72
2368,Hjemmeværnskommandoens,63,9,,1,63,9,,72
2369,maj-Parole,63,9,,1,63,9,,72
2370,Vordingborg,63,9,,1,63,9,,72
2371,Kaserne,63,9,,1,63,9,,72
2372,Hjemmeværnets,63,9,,1,63,9,,72
2373,Fortjensttegn,63,9,,1,63,9,,72
2374,diplom,63,9,,1,63,9,,72
2375,skønne,108,13,,3,36,4,,121
2376,blomst,80,12,,2,40,6,,92
2377,🏻#Brittagate,8,2,,1,8,2,,10
2378,øjeblik,88,13,,3,29,4,,101
2379,retssikkerhedskonference,55,4,,1,55,4,,59
2380,individuel,55,4,,1,55,4,,59
2381,vurdering,324,35,,11,29,3,,359
2382,https://t.co/XsYSZUzeuF,55,4,,1,55,4,,59
2383,oversættelse,44,17,,1,44,17,,61
2384,Bibelens,44,17,,1,44,17,,61
2385,Testamente,44,17,,1,44,17,,61
2386,Israel,127,23,,7,18,3,,150
2387,Israelisterne,44,17,,1,44,17,,61
2388,infam,44,17,,1,44,17,,61
2389,hærværk,61,19,,4,15,5,,80
2390,udtryk,484,36,,9,54,4,,520
2391,Himlens,78,24,,2,39,12,,102
2392,Fremragende,50,14,,4,12,4,,64
2393,Berlingske-journalistik,16,3,,1,16,3,,19
2394,Forrygende,16,3,,1,16,3,,19
2395,Forsvarets,16,3,,1,16,3,,19
2396,Efterretningstjeneste,16,3,,1,16,3,,19
2397,forsvarsminister,82,31,,4,20,8,,113
2398,aftrækker,46,4,,2,23,2,,50
2399,https://t.co/i33KzfiWq1,16,3,,1,16,3,,19
2400,Idenne,1,0,,1,1,0,,1
2401,led,523,60,,12,44,5,,583
2402,betalingsmur,25,9,,3,8,3,,34
2403,Berlingske,256,24,,11,23,2,,280
2404,ironisk,60,7,,2,30,4,,67
2405,idag,316,49,,11,29,4,,365
2406,østeuropæisk,41,8,,1,41,8,,49
2407,lastbil,54,10,,2,27,5,,64
2408,Storebælt,60,10,,2,30,5,,70
2409,Mærkelig,41,8,,1,41,8,,49
2410,optage,107,12,,4,27,3,,119
2411,kamerakontrol,1,0,,1,1,0,,1
2412,interview,941,102,,23,41,4,,1043
2413,dkfisk,1,0,,1,1,0,,1
2414,dkfood,1,0,,1,1,0,,1
2415,Lyngby,38,6,,3,13,2,,44
2416,Hovedgade,20,5,,1,20,5,,25
2417,Magasin,20,5,,1,20,5,,25
2418,Deler,20,5,,1,20,5,,25
2419,hilse,30,6,,4,8,2,,36
2420,Slotsholmen,20,5,,1,20,5,,25
2421,P1.#dkpol,20,5,,1,20,5,,25
2422,himmel,9,0,,1,9,0,,9
2423,skrive,3,0,,1,3,0,,3
2424,pæn,797,30,,10,80,3,,827
2425,tankevækkende,18,4,,1,18,4,,22
2426,seriøs,353,47,,14,25,3,,400
2427,eftertænksomhed,18,4,,1,18,4,,22
2428,Håber,18,4,,1,18,4,,22
2429,!https://t.co,18,4,,1,18,4,,22
2430,oplægsholder,22,2,,2,11,1,,24
2431,forskningsresultat,1,0,,1,1,0,,1
2432,https://t.co/AhYu47hqgg,0,0,,1,0,0,,0
2433,https://t.co/h5ErtNSezG,0,0,,1,0,0,,0
2434,Asylstop,46,7,,3,15,2,,53
2435,https://t.co/x7ZlSA1Vkh,1,1,,1,1,1,,2
2436,omhu,26,1,,2,13,0,,27
2437,Luciano,3,0,,1,3,0,,3
2438,Pavarotti,3,0,,1,3,0,,3
2439,sings,3,0,,1,3,0,,3
2440,Che,3,0,,1,3,0,,3
2441,gelida,3,0,,1,3,0,,3
2442,manina,3,0,,1,3,0,,3
2443,https://t.co/x98T3qeI0d,3,0,,1,3,0,,3
2444,Juletræsfest,43,8,,1,43,8,,51
2445,🏻en,43,8,,1,43,8,,51
2446,eftermiddag,211,33,,6,35,6,,244
2447,https://t.co/Nr5Essyv2,43,8,,1,43,8,,51
2448,Tænk,579,66,,10,58,7,,645
2449,fingre,248,32,,7,35,5,,280
2450,billede,1173,78,,19,62,4,,1251
2451,Facebook,123,22,,13,9,2,,145
2452,http://t.co/AvZITxftPQ,0,0,,1,0,0,,0
2453,vold,937,130,,22,43,6,,1067
2454,kvindekrisecenterne,13,2,,1,13,2,,15
2455,mandecentrene,13,2,,1,13,2,,15
2456,syg,70,19,,6,12,3,,89
2457,fod,44,6,,5,9,1,,50
2458,https://t.co/N97wXE4udP,6,4,,1,6,4,,10
2459,Klimapolitik,27,4,,2,14,2,,31
2460,frihedskamp,8,0,,1,8,0,,8
2461,stopsocialismen,8,0,,1,8,0,,8
2462,https://t.co/wza83ZQlY7,8,0,,1,8,0,,8
2463,aprilsnar,3,2,,2,2,1,,5
2464,http://t.co/l7omPUiZfh,0,0,,1,0,0,,0
2465,krigssti,22,7,,1,22,7,,29
2466,bevæbne,92,21,,3,31,7,,113
2467,bødeblok,22,7,,1,22,7,,29
2468,kuglepen,23,7,,3,8,2,,30
2469,rigspolitichef,22,7,,1,22,7,,29
2470,såre,1,1,,1,1,1,,2
2471,tragisk,32,3,,3,11,1,,35
2472,SriLanka,1,1,,1,1,1,,2
2473,dyb,8,3,,3,3,1,,11
2474,medfølelse,57,5,,4,14,1,,62
2475,https://t.co/2hxO0da0rJ,1,1,,1,1,1,,2
2476,boligskatterne,22,16,,2,11,8,,38
2477,https://t.co/sVT9Dc1rgL,9,6,,1,9,6,,15
2478,prøve,0,0,,2,0,0,,0
2479,https://t.co/7nzZ1CkKCR,0,0,,1,0,0,,0
2480,Elvis,3,0,,1,3,0,,3
2481,Messerschmidt,298,13,,2,149,6,,311
2482,finbil,3,0,,1,3,0,,3
2483,elvispresley,3,0,,1,3,0,,3
2484,messerschmitt,3,0,,1,3,0,,3
2485,https://t.co/LkG51TFAjU,3,0,,1,3,0,,3
2486,https://t.co/oxuF1NkTs9,59,16,,1,59,16,,75
2487,alvorlig,902,113,,12,75,9,,1015
2488,overtrædelse,35,8,,2,18,4,,43
2489,terrorlovgivningen,34,8,,1,34,8,,42
2490,Pernille,130,18,,8,16,2,,148
2491,Skipper,265,32,,4,66,8,,297
2492,Mærsk,49,8,,4,12,2,,57
2493,oprydning,3,1,,2,2,0,,4
2494,plast,3,1,,1,3,1,,4
2495,verdenshav,3,1,,1,3,1,,4
2496,maritim,3,1,,1,3,1,,4
2497,operatør,3,1,,1,3,1,,4
2498,generation,3250,856,,9,361,95,,4106
2499,Claus,9,1,,2,4,0,,10
2500,https://t.co/OvRWyMemT7,3,1,,1,3,1,,4
2501,https://t.co/YcgL6k1VOQ,0,0,,1,0,0,,0
2502,gigant,270,17,,3,90,6,,287
2503,Ordet,120,6,,1,120,6,,126
2504,nationalskjald,120,6,,1,120,6,,126
2505,overdrivelse,120,6,,1,120,6,,126
2506,sang,274,14,,4,68,4,,288
2507,fan,445,17,,8,56,2,,462
2508,Hvil,203,9,,2,102,4,,212
2509,kimlarsen,120,6,,1,120,6,,126
2510,udrejsecenter,47,11,,1,47,11,,58
2511,Sjælsmark,145,37,,2,72,18,,182
2512,mad,515,29,,8,64,4,,544
2513,rigelig,49,12,,3,16,4,,61
2514,Vesten,77,9,,3,26,3,,86
2515,blok,991,76,,17,58,4,,1067
2516,Kina,221,49,,12,18,4,,270
2517,wto,73,8,,1,73,8,,81
2518,velfærdslov,8,1,,1,8,1,,9
2519,kongres,11,2,,2,6,1,,13
2520,personlig,621,78,,16,39,5,,699
2521,migrations-svindel,22,9,,1,22,9,,31
2522,Slynglerne,22,9,,1,22,9,,31
2523,storsind,61,10,,3,20,3,,71
2524,England,34,9,,2,17,4,,43
2525,stakkels,23,9,,2,12,4,,32
2526,https://t.co/v8AZkLJtTb,22,9,,1,22,9,,31
2527,forudse,7,2,,1,7,2,,9
2528,tilbageregulere,7,2,,1,7,2,,9
2529,lukningstidspunktet,7,2,,1,7,2,,9
2530,smitterisiko,45,7,,3,15,2,,52
2531,https://t.co/yWvqsOj5i7,7,2,,1,7,2,,9
2532,brev,0,0,,2,0,0,,0
2533,HTS,34,19,,7,5,3,,53
2534,https://t.co/RAqWh2YonX,0,0,,1,0,0,,0
2535,Navn,34,7,,1,34,7,,41
2536,Winston,34,7,,1,34,7,,41
2537,Sådan,14,3,,2,7,2,,17
2538,Fantastisk,281,46,,10,28,5,,327
2539,afslutning,985,41,,4,246,10,,1026
2540,valgkampsbog,2,0,,1,2,0,,2
2541,Ellemann,99,11,,4,25,3,,110
2542,rytterstatue,3,0,,1,3,0,,3
2543,Frederik,49,6,,3,16,2,,55
2544,udmærke,7,0,,2,4,0,,7
2545,fuld,492,75,,27,18,3,,567
2546,exit,7,1,,2,4,0,,8
2547,komma,4,0,,1,4,0,,4
2548,suv.overdr,4,0,,1,4,0,,4
2549,Flot,2965,98,,13,228,8,,3063
2550,byråd,108,16,,3,36,5,,124
2551,https://t.co/UxFkGa22Yp,98,13,,1,98,13,,111
2552,ambition,454,63,,14,32,4,,517
2553,omfordeling,125,13,,5,25,3,,138
2554,bekendt,443,45,,11,40,4,,488
2555,https://t.co/97b3WgWO7d,4,0,,1,4,0,,4
2556,Stat,155,32,,5,31,6,,187
2557,krigslykke,93,18,,1,93,18,,111
2558,humanitær,98,26,,3,33,9,,124
2559,lokalområde,120,21,,3,40,7,,141
2560,https://t.co/J4BqHM0vh2,93,18,,1,93,18,,111
2561,floskel,0,1,,1,0,1,,1
2562,Jubii,76,12,,2,38,6,,88
2563,forhold,908,108,,30,30,4,,1016
2564,https://t.co/rzP59haQBF,58,11,,1,58,11,,69
2565,Indvandringen,14,3,,2,7,2,,17
2566,Hunden,4,1,,1,4,1,,5
2567,uren,4,1,,1,4,1,,5
2568,rase,329,4,,6,55,1,,333
2569,klimafesten,29,6,,1,29,6,,35
2570,regning,637,102,,12,53,8,,739
2571,https://t.co/iRcksX7bbz,29,6,,1,29,6,,35
2572,kontakt,11,5,,3,4,2,,16
2573,LEV,0,0,,1,0,0,,0
2574,debatmøde,35,4,,3,12,1,,39
2575,retspol,10,2,,1,10,2,,12
2576,kommunikation,33,5,,4,8,1,,38
2577,Kruså,10,2,,1,10,2,,12
2578,meningsudveksling,10,2,,1,10,2,,12
2579,Pape,194,52,,13,15,4,,246
2580,Loyal,154,22,,2,77,11,,176
2581,Familia,154,22,,2,77,11,,176
2582,LTF,53,14,,2,26,7,,67
2583,Første,302,40,,7,43,6,,342
2584,ældrebyrde,48,3,,1,48,3,,51
2585,socialdemokrat,93,10,,5,19,2,,103
2586,Venstre-politiker,48,3,,1,48,3,,51
2587,betegnelse,76,4,,3,25,1,,80
2588,Præsident,99,7,,1,99,7,,106
2589,Joe,207,14,,3,69,5,,221
2590,Biden,278,21,,9,31,2,,299
2591,Donald,320,19,,3,107,6,,339
2592,åbning,298,14,,6,50,2,,312
2593,Covid_19,35,6,,2,18,3,,41
2594,https://t.co/51fGFRrqRG,1,1,,1,1,1,,2
2595,billet,22,3,,2,11,2,,25
2596,https://t.co/pfwk0vwOL6,19,3,,1,19,3,,22
2597,https://t.co/8bRcgBlFW0,2,0,,1,2,0,,2
2598,udlændingeområde,288,42,,3,96,14,,330
2599,Ydelserne,53,13,,1,53,13,,66
2600,bønnekald,53,13,,1,53,13,,66
2601,udlændingepolitik,1571,206,,25,63,8,,1777
2602,Finansministeriet,71,23,,4,18,6,,94
2603,fremskrivning,0,0,,1,0,0,,0
2604,ikke-vestlig,0,0,,1,0,0,,0
2605,mærkning,6,1,,1,6,1,,7
2606,halal,6,1,,1,6,1,,7
2607,Poul,657,32,,6,110,5,,689
2608,ligeglad,410,34,,7,59,5,,444
2609,26.,51,9,,2,26,4,,60
2610,Maj,19,5,,1,19,5,,24
2611,ep-valget,19,5,,1,19,5,,24
2612,Juni,396,33,,5,79,7,,429
2613,misunde,19,5,,1,19,5,,24
2614,https://t.co/9oRw0kkNRf,19,5,,1,19,5,,24
2615,Boligjob,3,2,,1,3,2,,5
2616,håndværkerydelser,3,2,,1,3,2,,5
2617,lærlingepladser,3,2,,1,3,2,,5
2618,https://t.co/KLg6pu7ARb,3,2,,1,3,2,,5
2619,versere,0,0,,1,0,0,,0
2620,problemstilling,18,2,,3,6,1,,20
2621,valgperiode,333,31,,4,83,8,,364
2622,dør,263,53,,6,44,9,,316
2623,lyst,124,20,,6,21,3,,144
2624,øre,39,3,,2,20,2,,42
2625,svindelsigtedes,20,0,,1,20,0,,20
2626,Nielsens,20,0,,2,10,0,,20
2627,stjerneadvokats,20,0,,1,20,0,,20
2628,bagmandspoliti,20,0,,1,20,0,,20
2629,Socialstyrelsen,20,0,,1,20,0,,20
2630,afledningsmanøvre,20,0,,1,20,0,,20
2631,anklage,32,0,,2,16,0,,32
2632,storsvindel,20,0,,1,20,0,,20
2633,Skuespiller,20,0,,1,20,0,,20
2634,bid,2,1,,2,1,0,,3
2635,Karina,0,1,,1,0,1,,1
2636,valg2015,2,1,,3,1,0,,3
2637,photooftheday,0,1,,1,0,1,,1
2638,adsbølvalg,0,1,,1,0,1,,1
2639,https://t.co/j2PbQnZq6,0,1,,1,0,1,,1
2640,Ahsan,1,0,,1,1,0,,1
2641,tørklæde,243,28,,3,81,9,,271
2642,https://t.co/emZxZr7cIM,1,0,,1,1,0,,1
2643,https://t.co/KsWkoPNe9W,1,0,,1,1,0,,1
2644,forbyde,200,16,,7,29,2,,216
2645,Byret,101,8,,1,101,8,,109
2646,kendelse,102,9,,2,51,4,,111
2647,tide,191,34,,10,19,3,,225
2648,Dam,351,20,,4,88,5,,371
2649,angribe,262,37,,14,19,3,,299
2650,Paris,40,10,,4,10,2,,50
2651,flok,96,51,,6,16,8,,147
2652,kujon,1,1,,1,1,1,,2
2653,uskyldig,181,18,,7,26,3,,199
2654,død,2,1,,2,1,0,,3
2655,ParisAttacks,1,1,,1,1,1,,2
2656,ministerium,86,4,,8,11,0,,90
2657,almindelig,952,89,,16,60,6,,1041
2658,arbejdsdag,72,4,,3,24,1,,76
2659,Statsministeriet,71,4,,1,71,4,,75
2660,sikkerhedstøj,71,4,,1,71,4,,75
2661,Nice,0,0,,1,0,0,,0
2662,know,50,2,,2,25,1,,52
2663,Prins,44,3,,2,22,2,,47
2664,Joakim,0,0,,1,0,0,,0
2665,AaB,1,0,,2,0,0,,1
2666,Joachim,44,3,,2,22,2,,47
2667,bror,46,11,,3,15,4,,57
2668,venstrefløjsparti,70,12,,2,35,6,,82
2669,blokpolitik,101,15,,2,50,8,,116
2670,NYT,4,1,,1,4,1,,5
2671,UDREJSECENTER,4,1,,1,4,1,,5
2672,UDVISTE,4,1,,1,4,1,,5
2673,KRIMINELLE,4,1,,1,4,1,,5
2674,UDLÆNDINGE,4,1,,1,4,1,,5
2675,DEL,4,1,,1,4,1,,5
2676,GODE,4,1,,1,4,1,,5
2677,NYHED,4,1,,1,4,1,,5
2678,Udviste,4,1,,1,4,1,,5
2679,https://t.co/KGkNAMaRvo,4,1,,1,4,1,,5
2680,skandale,157,40,,8,20,5,,197
2681,Medicinrådets,37,7,,1,37,7,,44
2682,Victor,38,7,,2,19,4,,45
2683,livskvalitet,152,22,,3,51,7,,174
2684,selvhjulpet,37,7,,1,37,7,,44
2685,sundpol,2427,374,,60,40,6,,2801
2686,SMA,37,7,,1,37,7,,44
2687,https://t.co/n43oDE4iYa,37,7,,1,37,7,,44
2688,Black,86,9,,1,86,9,,95
2689,Lives,86,9,,1,86,9,,95
2690,Matter-demoen,86,9,,1,86,9,,95
2691,Corona-Superspreder-Suppe,86,9,,1,86,9,,95
2692,Karsten,722,34,,3,241,11,,756
2693,Petersen,86,9,,1,86,9,,95
2694,Hvelplund,86,9,,1,86,9,,95
2695,Enh,86,9,,1,86,9,,95
2696,kåd,86,9,,1,86,9,,95
2697,svineri,227,18,,4,57,4,,245
2698,14-dages,86,9,,1,86,9,,95
2699,isolation,132,13,,4,33,3,,145
2700,risikere,13,1,,1,13,1,,14
2701,hyggelig,55,4,,3,18,1,,59
2702,marked,147,16,,4,37,4,,163
2703,forhindre,58,14,,4,14,4,,72
2704,https://t.co/iOMVEPr8hm,13,1,,1,13,1,,14
2705,messertweet,36,6,,2,18,3,,42
2706,Højt,37,6,,2,18,3,,43
2707,humør,129,23,,5,26,5,,152
2708,detgrafiskedepartement,34,6,,1,34,6,,40
2709,https://t.co/T3nd8jQs3c,34,6,,1,34,6,,40
2710,igangværende,4,2,,1,4,2,,6
2711,etc.,8,2,,5,2,0,,10
2712,berøre,138,18,,3,46,6,,156
2713,https://t.co/PGjJjFXzTg,4,2,,1,4,2,,6
2714,grusom,16,0,,1,16,0,,16
2715,terrorist,211,30,,7,30,4,,241
2716,allesammens,128,12,,1,128,12,,140
2717,gerningsmand,289,42,,3,96,14,,331
2718,vanvid,128,12,,1,128,12,,140
2719,indpasse,510,35,,2,255,18,,545
2720,vandalisme,128,12,,1,128,12,,140
2721,dkkultur,129,12,,2,64,6,,141
2722,Inspirerende,27,8,,2,14,4,,35
2723,integrationspolitik,14,2,,1,14,2,,16
2724,Seriøst,925,31,,6,154,5,,956
2725,https://t.co/GKbUiT5n3B,14,2,,1,14,2,,16
2726,telefon,7,0,,2,4,0,,7
2727,produktivitetskrav,7,5,,2,4,2,,12
2728,https://t.co/aP3IoXyx1Q,6,3,,1,6,3,,9
2729,russisk,6,3,,2,3,2,,9
2730,snus,0,0,,1,0,0,,0
2731,voldsom,53,17,,4,13,4,,70
2732,stigning,72,18,,7,10,3,,90
2733,smittetallene,43,13,,1,43,13,,56
2734,somalisk,43,13,,1,43,13,,56
2735,Borgmester,56,15,,2,28,8,,71
2736,Bundsgaards,43,13,,1,43,13,,56
2737,mundbind,60,13,,4,15,3,,73
2738,https://t.co/PVfd7cwKzE,43,13,,1,43,13,,56
2739,gymnasium,526,44,,17,31,3,,570
2740,lørdag,194,24,,10,19,2,,218
2741,superseje,5,1,,1,5,1,,6
2742,landsledelse,5,1,,1,5,1,,6
2743,LandboUngdom,5,1,,1,5,1,,6
2744,DMipløjning,5,1,,1,5,1,,6
2745,Pløjning,5,1,,1,5,1,,6
2746,https://t.co/8cfggfeNXx,5,1,,1,5,1,,6
2747,dokument,25,6,,2,12,3,,31
2748,ordre,612,82,,8,76,10,,694
2749,højde,25,6,,1,25,6,,31
2750,cpharena,8,1,,1,8,1,,9
2751,royalarena,8,1,,1,8,1,,9
2752,højrefløj,250,41,,7,36,6,,291
2753,Nørrebro,192,33,,6,32,6,,225
2754,https://t.co/LXLY5GTxHw,29,10,,1,29,10,,39
2755,magtfuldkomment,40,13,,1,40,13,,53
2756,Corona-krisen,398,62,,9,44,7,,460
2757,uendelighed,53,16,,2,26,8,,69
2758,orientering,182,29,,3,61,10,,211
2759,Socialdemokrater,82,11,,3,27,4,,93
2760,kostvejleder,4,2,,1,4,2,,6
2761,sult,34,9,,2,17,4,,43
2762,sovsogkartofler,4,2,,1,4,2,,6
2763,https://t.co/HXJFY85Szu,4,2,,1,4,2,,6
2764,afslapning,22,1,,1,22,1,,23
2765,ferie,455,20,,6,76,3,,475
2766,https://t.co/SgfruMvVt4,22,1,,1,22,1,,23
2767,Aldeles,96,22,,1,96,22,,118
2768,Stram,1190,79,,7,170,11,,1269
2769,Kurs,1188,79,,5,238,16,,1267
2770,Generalforsamling,96,22,,1,96,22,,118
2771,Mere,335,46,,10,34,5,,381
2772,statsborgerskab,1281,219,,20,64,11,,1500
2773,https://t.co/QVZAjzeC2l,40,6,,1,40,6,,46
2774,Stort,190,27,,15,13,2,,217
2775,tillykke,505,39,,22,23,2,,544
2776,https://t.co/KxWKPI1Lgh,6,1,,1,6,1,,7
2777,sundhedsudvalg,8,3,,1,8,3,,11
2778,egenbetaling,8,3,,1,8,3,,11
2779,sundhedssystem,15,3,,2,8,2,,18
2780,https://t.co/y6rXixKYVa,8,3,,1,8,3,,11
2781,Bent,5,2,,1,5,2,,7
2782,Greve,15,2,,3,5,1,,17
2783,Rumænien,31,8,,1,31,8,,39
2784,forbindelsesofficer,31,8,,1,31,8,,39
2785,https://t.co/Jy9RWyZ6Qf,31,8,,1,31,8,,39
2786,arbejdsgiver,18,4,,5,4,1,,22
2787,indhold,218,22,,8,27,3,,240
2788,gribe,7,4,,2,4,2,,11
2789,https://t.co/PQM8Iyl9bH,1,0,,1,1,0,,1
2790,https://t.co/BHuSw7Cdsp,0,1,,1,0,1,,1
2791,ikke-vestlige,43,12,,1,43,12,,55
2792,tilstrømning,75,15,,2,38,8,,90
2793,voldskriminalitet,43,12,,1,43,12,,55
2794,voldskultur,43,12,,1,43,12,,55
2795,Afrika,43,12,,2,22,6,,55
2796,Asien,44,14,,3,15,5,,58
2797,Ahh,1,1,,1,1,1,,2
2798,intention,10,3,,5,2,1,,13
2799,faktor,36,5,,2,18,2,,41
2800,udsøge,27,2,,1,27,2,,29
2801,indvielse,27,2,,1,27,2,,29
2802,Husum,54,4,,2,27,2,,58
2803,Boldklubs,27,2,,1,27,2,,29
2804,klubhus,54,4,,2,27,2,,58
2805,ordentlig,221,23,,14,16,2,,244
2806,kbhpol,64,8,,3,21,3,,72
2807,sen,1824,96,,14,130,7,,1920
2808,kampagne,1495,76,,15,100,5,,1571
2809,Copy-Cat,0,1,,1,0,1,,1
2810,http://t.co/ixop82R4UH,0,1,,1,0,1,,1
2811,nedslidt,328,65,,8,41,8,,393
2812,resultat,280,33,,10,28,3,,313
2813,optik,30,5,,1,30,5,,35
2814,https://t.co/NjIDWBEAh8,30,5,,1,30,5,,35
2815,vedtagelsestekst,5,1,,1,5,1,,6
2816,forespørgsel,5,1,,1,5,1,,6
2817,knappe,34,2,,2,17,1,,36
2818,juleferie,36,2,,4,9,0,,38
2819,fl18,28,2,,1,28,2,,30
2820,https://t.co/OHJggofvK6,28,2,,1,28,2,,30
2821,http://t.co/UF6sevYSkY,1,0,,1,1,0,,1
2822,GoodnightWithLove,1,0,,1,1,0,,1
2823,DF's,175,22,,4,44,6,,197
2824,øhavsprojektet,6,3,,1,6,3,,9
2825,Svendborg,6,3,,1,6,3,,9
2826,formand,993,59,,22,45,3,,1052
2827,brød,4,0,,1,4,0,,4
2828,Sommergruppemødet,4,0,,1,4,0,,4
2829,gevaldig,4,0,,1,4,0,,4
2830,kolbøtte,4,0,,1,4,0,,4
2831,https://t.co/ZAcgKDtp9k,4,0,,1,4,0,,4
2832,Samarbejdspartiet,1,2,,1,1,2,,3
2833,Atassut,1,2,,1,1,2,,3
2834,Demokraterne,1,2,,2,0,1,,3
2835,KNR,1,2,,1,1,2,,3
2836,https://t.co/clrUm9dKdy,1,2,,1,1,2,,3
2837,Østergaard,834,116,,8,104,14,,950
2838,tirsdag,202,28,,7,29,4,,230
2839,lempelse,133,27,,4,33,7,,160
2840,https://t.co/dHwvzXGqmf,1,0,,1,1,0,,1
2841,Smukt,19,2,,4,5,0,,21
2842,digt,3,4,,2,2,2,,7
2843,Mia,17,1,,2,8,0,,18
2844,blad,292,28,,7,42,4,,320
2845,Marts,1,1,,1,1,1,,2
2846,LMS,1,1,,1,1,1,,2
2847,https://t.co/rVNxxKTWxi,1,1,,1,1,1,,2
2848,følge,96,11,,3,32,4,,107
2849,Ritzau,0,0,,1,0,0,,0
2850,barnebrud,3,0,,2,2,0,,3
2851,mørketal,0,0,,1,0,0,,0
2852,kulturminister,26,7,,1,26,7,,33
2853,zoologisk,54,12,,2,27,6,,66
2854,corona-krisen,135,25,,3,45,8,,160
2855,https://t.co/BdmiuWZNeh,26,7,,1,26,7,,33
2856,Naser,42,2,,2,21,1,,44
2857,Khader,47,4,,3,16,1,,51
2858,https://t.co/e5mFChYj7Z,4,0,,1,4,0,,4
2859,venstreorienteret,78,8,,6,13,1,,86
2860,aktivist,1,0,,1,1,0,,1
2861,https://t.co/eppsXp7Ohy,1,0,,1,1,0,,1
2862,nødvendighed,86,21,,3,29,7,,107
2863,hård,887,106,,20,44,5,,993
2864,udvisningsstraffe,69,14,,1,69,14,,83
2865,udenlandsk,283,39,,8,35,5,,322
2866,https://t.co/yNnobymsOI,69,14,,1,69,14,,83
2867,Robinson-skandalen,52,6,,1,52,6,,58
2868,https://t.co/MckdGwZtFA,52,6,,1,52,6,,58
2869,tegning,32,7,,3,11,2,,39
2870,Valgfri,23,5,,1,23,5,,28
2871,Islamistiske,14,2,,1,14,2,,16
2872,video,375,47,,16,23,3,,422
2873,optøjer,14,2,,1,14,2,,16
2874,https://t.co/kYJBKaYXGM,14,2,,1,14,2,,16
2875,terrorangreb,408,33,,5,82,7,,441
2876,ondskab,21,3,,1,21,3,,24
2877,tanke,1114,80,,20,56,4,,1194
2878,Tyrkiet,22,4,,2,11,2,,26
2879,besiktas,21,3,,1,21,3,,24
2880,opstilling,16,6,,2,8,3,,22
2881,klinge,12,2,,1,12,2,,14
2882,https://t.co/DlTjOwsZFi,12,2,,1,12,2,,14
2883,dugfrisk,33,12,,1,33,12,,45
2884,ugebrev,33,12,,1,33,12,,45
2885,migration,305,103,,6,51,17,,408
2886,Middelhavet,104,31,,5,21,6,,135
2887,https://t.co/Lc3eGKV5KE,33,12,,1,33,12,,45
2888,utrolig,2,0,,1,2,0,,2
2889,Nord,310,17,,2,155,8,,327
2890,https://t.co/lTc2koqF5F,2,0,,1,2,0,,2
2891,rejse,295,38,,4,74,10,,333
2892,https://t.co/BfRdc1rwze,216,23,,1,216,23,,239
2893,gul,69,25,,2,34,12,,94
2894,jakke,41,21,,1,41,21,,62
2895,drdinstemme,41,21,,1,41,21,,62
2896,skinger,41,21,,1,41,21,,62
2897,monoton,41,21,,1,41,21,,62
2898,internationale,281,43,,12,23,4,,324
2899,filmpriser,14,1,,1,14,1,,15
2900,lidenhed,14,1,,1,14,1,,15
2901,nation,73,8,,2,36,4,,81
2902,dkfilm,14,1,,1,14,1,,15
2903,film,49,6,,7,7,1,,55
2904,https://t.co/BPcZzIbYmg,14,1,,1,14,1,,15
2905,faktuel,19,1,,3,6,0,,20
2906,kendsgerning,157,13,,2,78,6,,170
2907,milliardstøtte,5,1,,1,5,1,,6
2908,erhvervsfrekvens,5,1,,1,5,1,,6
2909,BNP,11,7,,2,6,4,,18
2910,https://t.co/By0PMhd3JP,5,1,,1,5,1,,6
2911,restriktion,540,31,,12,45,3,,571
2912,restriktionsperioden,47,4,,1,47,4,,51
2913,17.,48,6,,3,16,2,,54
2914,januar,204,22,,5,41,4,,226
2915,vished,47,4,,1,47,4,,51
2916,https://t.co/OFluG0NH1J,2,2,,1,2,2,,4
2917,Sneaky,2,0,,1,2,0,,2
2918,couch,2,0,,1,2,0,,2
2919,https://t.co/ADmui2ic4F,2,0,,1,2,0,,2
2920,Konventioner,8,4,,1,8,4,,12
2921,demokratisk,304,46,,16,19,3,,350
2922,https://t.co/fVsEAWRIqc,8,4,,1,8,4,,12
2923,Forældre,0,0,,2,0,0,,0
2924,oprør,19,3,,2,10,2,,22
2925,pædagog-jobs,0,0,,1,0,0,,0
2926,DSB,1,1,,4,0,0,,2
2927,id-kontrollen,0,0,,1,0,0,,0
2928,stil,157,13,,8,20,2,,170
2929,https://t.co/mOJPseNWif,8,0,,1,8,0,,8
2930,Christiansborgs,129,9,,4,32,2,,138
2931,sekretariatschef,16,2,,1,16,2,,18
2932,Jeanie,16,2,,1,16,2,,18
2933,Nørhave,16,2,,1,16,2,,18
2934,gruppeværelse,16,2,,1,16,2,,18
2935,dk.pol,43,7,,2,22,4,,50
2936,småbørnsfamilie,3,1,,1,3,1,,4
2937,Regn,3,1,,1,3,1,,4
2938,Bjarke,11,2,,2,6,1,,13
2939,vestlig,238,31,,5,48,6,,269
2940,efterretningstjeneste,206,15,,4,52,4,,221
2941,vågne,21,5,,1,21,5,,26
2942,https://t.co/DssFUgvjxR,21,5,,1,21,5,,26
2943,lange,627,95,,22,28,4,,722
2944,institutionsdage,0,0,,1,0,0,,0
2945,tortur,38,5,,2,19,2,,43
2946,finale,16,1,,1,16,1,,17
2947,https://t.co/S2ZVqDUU3Q,16,1,,1,16,1,,17
2948,https://t.co/Pj39yXu0CZ,0,0,,1,0,0,,0
2949,asylsøger,76,14,,1,76,14,,90
2950,Skaarup,76,14,,1,76,14,,90
2951,soc,76,14,,1,76,14,,90
2952,https://t.co/fZdhhtTiTW,0,1,,1,0,1,,1
2953,særhensyn,3,0,,1,3,0,,3
2954,Lovprisning,17,5,,1,17,5,,22
2955,vaccine,17,5,,1,17,5,,22
2956,Coronavirus,418,38,,2,209,19,,456
2957,Stålsatte,14,5,,2,7,2,,19
2958,øjne,159,38,,10,16,4,,197
2959,træ,80,9,,5,16,2,,89
2960,Åhr,0,0,,1,0,0,,0
2961,Jacob,1,0,,3,0,0,,1
2962,bunke,34,2,,2,17,1,,36
2963,grønlænder,0,0,,1,0,0,,0
2964,gud,2,0,,2,1,0,,2
2965,jamre,2,3,,2,1,2,,5
2966,Egedes,0,0,,1,0,0,,0
2967,initiativ,426,74,,21,20,4,,500
2968,trappe,119,27,,3,40,9,,146
2969,Medlemmer,29,4,,1,29,4,,33
2970,strømme,29,4,,1,29,4,,33
2971,Kongrescenteret,29,4,,1,29,4,,33
2972,Herning,150,27,,7,21,4,,177
2973,https://t.co/L40KyyOjOS,29,4,,1,29,4,,33
2974,https://t.co/yNxEAaJOpa,62,10,,1,62,10,,72
2975,tomhed,15,3,,1,15,3,,18
2976,fællesskab,1005,121,,25,40,5,,1126
2977,forpligte,145,8,,3,48,3,,153
2978,fællesskaber!#dkpol,15,3,,1,15,3,,18
2979,https://t.co/8aNvJ6bCgA,15,3,,1,15,3,,18
2980,røverhistorie,72,3,,2,36,2,,75
2981,konservativ,492,40,,15,33,3,,532
2982,stue,63,3,,2,32,2,,66
2983,borgerrepræsentation,38,2,,1,38,2,,40
2984,https://t.co/yot1YUx2M1,38,2,,1,38,2,,40
2985,TrygFonden,21,1,,1,21,1,,22
2986,oprette,21,1,,1,21,1,,22
2987,akutpulje,21,1,,1,21,1,,22
2988,Puljen,21,1,,1,21,1,,22
2989,forening,104,12,,6,17,2,,116
2990,https://t.co/buBBcsk52X,21,1,,1,21,1,,22
2991,Ekstra,293,23,,7,42,3,,316
2992,free,60,36,,2,30,18,,96
2993,bleeding,0,0,,1,0,0,,0
2994,opgør,239,41,,9,27,5,,280
2995,bind,1,0,,2,0,0,,1
2996,tampon,0,0,,1,0,0,,0
2997,menstruation,0,0,,1,0,0,,0
2998,mystisk,2,0,,2,1,0,,2
2999,http://t.co/qcLNYuCHuJ,0,0,,1,0,0,,0
3000,ø-tur,15,1,,1,15,1,,16
3001,Aarø,45,3,,3,15,1,,48
3002,Sønderjyske,15,1,,1,15,1,,16
3003,Vingård,15,1,,1,15,1,,16
3004,Bryg,15,1,,1,15,1,,16
3005,Brummers,15,1,,1,15,1,,16
3006,Gård,15,1,,1,15,1,,16
3007,ø-ordfører,15,1,,1,15,1,,16
3008,https://t.co/kEuWcAxpP9,15,1,,1,15,1,,16
3009,Underligt,0,1,,1,0,1,,1
3010,https://t.co/qbLqsKPJtw,0,0,,1,0,0,,0
3011,nervøs,0,0,,1,0,0,,0
3012,https://t.co/OE9Y6lERie,26,5,,1,26,5,,31
3013,følgere,98,0,,2,49,0,,98
3014,ALLE,81,9,,3,27,3,,90
3015,begribe,5,0,,3,2,0,,5
3016,ophold,72,19,,3,24,6,,91
3017,Stigning,1,0,,1,1,0,,1
3018,tyveri,2,1,,2,1,0,,3
3019,Mors,21,4,,4,5,1,,25
3020,tilgængelig,73,13,,5,15,3,,86
3021,🏻#dkpol,13,2,,1,13,2,,15
3022,https://t.co/A048HFwB5Z,13,2,,1,13,2,,15
3023,skralde,1,1,,1,1,1,,2
3024,dokumentar,6,5,,2,3,2,,11
3025,udvise,176,6,,4,44,2,,182
3026,voldsmand,179,16,,1,179,16,,195
3027,Hans,185,17,,3,62,6,,202
3028,Skibby,179,16,,1,179,16,,195
3029,plejehjem,478,65,,10,48,6,,543
3030,pårørende,273,37,,7,39,5,,310
3031,hjerteskærende,45,3,,1,45,3,,48
3032,forår,318,17,,7,45,2,,335
3033,indkalde,45,3,,1,45,3,,48
3034,hastesamråd,45,3,,1,45,3,,48
3035,https://t.co/nrzxpI7EuV,45,3,,1,45,3,,48
3036,Ældre,35,7,,2,18,4,,42
3037,ældredet,8,0,,1,8,0,,8
3038,https://t.co/CTAuIF79pl,8,0,,1,8,0,,8
3039,landdistrikt,107,25,,3,36,8,,132
3040,https://t.co/PvlyhipezJ,15,4,,1,15,4,,19
3041,Prinsgemalen,1,1,,1,1,1,,2
3042,dronningensnytaarstale,1,1,,1,1,1,,2
3043,https://t.co/tfIGhfscBY,14,3,,1,14,3,,17
3044,https://t.co/vV8ryAWYcv,50,5,,1,50,5,,55
3045,Taler,28,7,,1,28,7,,35
3046,smitte,250,40,,10,25,4,,290
3047,udlændingelov,61,17,,2,30,8,,78
3048,https://t.co/F7iE7GI6Yt,57,16,,1,57,16,,73
3049,dækningsafgift,3,1,,1,3,1,,4
3050,primær,582,33,,2,291,16,,615
3051,detailhandel,11,2,,2,6,1,,13
3052,hotel,48,2,,2,24,1,,50
3053,restaurationsbranchen,3,1,,1,3,1,,4
3054,USA's,27,3,,3,9,1,,30
3055,Nordkorea,14,2,,3,5,1,,16
3056,Historiens,26,6,,2,13,3,,32
3057,vingesus,21,3,,2,10,2,,24
3058,Kritik,15,4,,1,15,4,,19
3059,Samuelsen,29,9,,3,10,3,,38
3060,2-årigt,15,4,,1,15,4,,19
3061,trump,15,4,,1,15,4,,19
3062,dkforsvar,0,0,,1,0,0,,0
3063,https://t.co/TC5PsJcWWu,6,0,,1,6,0,,6
3064,pleased,2,2,,1,2,2,,4
3065,shadow,2,2,,1,2,2,,4
3066,committee,2,2,,1,2,2,,4
3067,Tax,4,4,,2,2,2,,8
3068,Rulings,2,2,,1,2,2,,4
3069,These,2,2,,1,2,2,,4
3070,rules,2,2,,1,2,2,,4
3071,authority,2,2,,1,2,2,,4
3072,broderfolk,47,9,,1,47,9,,56
3073,skæbnestund,47,9,,1,47,9,,56
3074,ligegyldig,164,17,,6,27,3,,181
3075,tosseri,47,9,,1,47,9,,56
3076,Atlanten,47,9,,1,47,9,,56
3077,https://t.co/Q5ZX0Oxbsp,47,9,,1,47,9,,56
3078,Opsættende,40,6,,1,40,6,,46
3079,virkning,137,19,,4,34,5,,156
3080,kompensationsordning,40,6,,1,40,6,,46
3081,Tro-,40,6,,1,40,6,,46
3082,erklæring,48,6,,2,24,3,,54
3083,genbevilling,40,6,,1,40,6,,46
3084,hjælpemiddel,40,6,,1,40,6,,46
3085,osv.,88,9,,6,15,2,,97
3086,https://t.co/uOJT1hlvgC,40,6,,1,40,6,,46
3087,Njahr,7,0,,1,7,0,,7
3088,Pauli,7,0,,1,7,0,,7
3089,tie,50,5,,5,10,1,,55
3090,forsamling,22,1,,3,7,0,,23
3091,Velkommen,208,20,,9,23,2,,228
3092,Ravn,1,1,,1,1,1,,2
3093,Morgentræning,2,0,,1,2,0,,2
3094,romaskine,2,0,,1,2,0,,2
3095,"3x10(24,26,28,30",2,0,,1,2,0,,2
3096,https://t.co/4BMJjTgUSr,2,0,,1,2,0,,2
3097,gennemsnit,89,0,,3,30,0,,89
3098,http://t.co/a2K1lKYOwo,1,0,,1,1,0,,1
3099,Udflytning,1,0,,1,1,0,,1
3100,hospital,22,12,,4,6,3,,34
3101,ældresektor,1,0,,1,1,0,,1
3102,ikle,1,0,,1,1,0,,1
3103,https://t.co/3Ve0Z593m0,1,0,,1,1,0,,1
3104,optagelse,71,10,,4,18,2,,81
3105,Jens,52,6,,4,13,2,,58
3106,missil,18,6,,1,18,6,,24
3107,flamme,18,6,,1,18,6,,24
3108,https://t.co/zi8zJxPvPm,18,6,,1,18,6,,24
3109,iÅrhus,1,0,,1,1,0,,1
3110,maj,155,24,,7,22,3,,179
3111,https://t.co/aidJJEnizF,1,0,,1,1,0,,1
3112,jagtmark,72,6,,1,72,6,,78
3113,skønt,85,7,,2,42,4,,92
3114,grønlandsk,79,7,,2,40,4,,86
3115,regerings-politiker,72,6,,1,72,6,,78
3116,Grønland,89,8,,3,30,3,,97
3117,"Rigsfællesskabet?""#dkpol",72,6,,1,72,6,,78
3118,Godnat,0,2,,2,0,1,,2
3119,https://t.co/fLyDcnlEPZ,4,2,,1,4,2,,6
3120,Manden,56,4,,3,19,1,,60
3121,bindegal,2,2,,1,2,2,,4
3122,kampdag,100,25,,5,20,5,,125
3123,Lindholm,165,12,,2,82,6,,177
3124,bastion,20,2,,1,20,2,,22
3125,beboer,22,3,,3,7,1,,25
3126,fængselsforbund,20,2,,1,20,2,,22
3127,https://t.co/h9jXCqAntS,20,2,,1,20,2,,22
3128,Grundlovens,18,0,,2,9,0,,18
3129,udvidelse,74,20,,2,37,10,,94
3130,udendørs,44,12,,1,44,12,,56
3131,efterskole,44,12,,1,44,12,,56
3132,SØREN,63,7,,2,32,4,,70
3133,ESPERSEN,35,6,,1,35,6,,41
3134,BØR,35,6,,1,35,6,,41
3135,ATTER,35,6,,1,35,6,,41
3136,Påske,35,6,,1,35,6,,41
3137,atter,69,16,,2,34,8,,85
3138,ansigt,76,13,,4,19,3,,89
3139,rimelig,228,26,,10,23,3,,254
3140,Grimhøjmoskeens,20,5,,1,20,5,,25
3141,talsmand,287,27,,3,96,9,,314
3142,passiv,20,5,,1,20,5,,25
3143,forsvar,48,8,,8,6,1,,56
3144,Grotesk,22,5,,2,11,2,,27
3145,https://t.co/oOrsyHtERP,20,5,,1,20,5,,25
3146,Fake,28,9,,1,28,9,,37
3147,Hamas,28,9,,1,28,9,,37
3148,ussel,259,20,,3,86,7,,279
3149,https://t.co/NUASW8iO1,28,9,,1,28,9,,37
3150,Traditionen,21,12,,2,10,6,,33
3151,økologisk,22,2,,4,6,0,,24
3152,april,35,6,,4,9,2,,41
3153,økodag,8,2,,1,8,2,,10
3154,veganer,8,2,,1,8,2,,10
3155,Brexit,541,62,,6,90,10,,603
3156,Get,67,8,,1,67,8,,75
3157,Hærværk,0,1,,1,0,1,,1
3158,værtshus,2,1,,2,1,0,,3
3159,forældrepålæg,0,1,,1,0,1,,1
3160,ungepålæg,0,1,,1,0,1,,1
3161,beretning,121,9,,3,40,3,,130
3162,mandat,358,53,,18,20,3,,411
3163,Stolt,291,38,,5,58,8,,329
3164,afrikansk,49,20,,2,24,10,,69
3165,rod,60,16,,7,9,2,,76
3166,neger,16,1,,3,5,0,,17
3167,tipoldemor,8,1,,1,8,1,,9
3168,Wilhelmine,8,1,,1,8,1,,9
3169,Hennemann,8,1,,1,8,1,,9
3170,https://t.co/PBBBuqN28A,8,1,,1,8,1,,9
3171,Sundhedsministeren,8,3,,1,8,3,,11
3172,patienterstatninger,8,3,,1,8,3,,11
3173,DF-ordfører,8,3,,1,8,3,,11
3174,https://t.co/ApzzRd1VoN,8,3,,1,8,3,,11
3175,ordfoerer-under-al-kritik/,8,3,,1,8,3,,11
3176,Store,43,2,,2,22,1,,45
3177,monopol,8,1,,2,4,0,,9
3178,Sammenhængskraften,17,1,,2,8,0,,18
3179,dfaam20,8,1,,1,8,1,,9
3180,massiv,1511,143,,9,168,16,,1654
3181,strøm,2,0,,2,1,0,,2
3182,Ekstra-Bladet,84,6,,2,42,3,,90
3183,kongelig,26,4,,2,13,2,,30
3184,unfair,13,2,,1,13,2,,15
3185,vammel,13,2,,1,13,2,,15
3186,facon,13,2,,1,13,2,,15
3187,storartet,13,2,,1,13,2,,15
3188,Usselt,13,2,,1,13,2,,15
3189,https://t.co/j6gbGtaAPx,13,2,,1,13,2,,15
3190,fysioterapeut,8,1,,1,8,1,,9
3191,afhængig,169,9,,3,56,3,,178
3192,henvisning,8,1,,1,8,1,,9
3193,https://t.co/rq3GoSSKY9,4,1,,1,4,1,,5
3194,Overfaldet,27,4,,1,27,4,,31
3195,vride,42,4,,3,14,1,,46
3196,motivere,27,4,,1,27,4,,31
3197,bedring,80,7,,4,20,2,,87
3198,provins-DK,26,6,,1,26,6,,32
3199,Husker,26,6,,1,26,6,,32
3200,indtægt,81,22,,7,12,3,,103
3201,https://t.co/qYEqMTUPbR,26,6,,1,26,6,,32
3202,nørderi,2,2,,1,2,2,,4
3203,britisk,81,19,,3,27,6,,100
3204,Gæster,2,2,,1,2,2,,4
3205,Niels,277,32,,7,40,5,,309
3206,tordne,52,11,,1,52,11,,63
3207,Socialdemokratiets,215,35,,7,31,5,,250
3208,forhøjelse,52,11,,1,52,11,,63
3209,https://t.co/Wywv2HdHF5,52,11,,1,52,11,,63
3210,DR2,213,37,,10,21,4,,250
3211,brexit,244,42,,6,41,7,,286
3212,dexit,67,5,,1,67,5,,72
3213,Byen,68,5,,2,34,2,,73
3214,Station,72,6,,3,24,2,,78
3215,https://t.co/AUoJrBdpuo,67,5,,1,67,5,,72
3216,https://t.co/Cdc15GfgZW,1,0,,1,1,0,,1
3217,TILSTÅELSE,99,9,,1,99,9,,108
3218,research,99,9,,1,99,9,,108
3219,væsentlig,346,32,,7,49,5,,378
3220,Liberal,176,19,,7,25,3,,195
3221,Alliance,153,15,,5,31,3,,168
3222,Klaus,103,10,,4,26,2,,113
3223,Riskær,101,9,,2,50,4,,110
3224,Pedersen,160,21,,5,32,4,,181
3225,Fremad,152,16,,3,51,5,,168
3226,Annonce,56,9,,1,56,9,,65
3227,undersøgelseskommission,114,19,,6,19,3,,133
3228,nedsætte,100,16,,2,50,8,,116
3229,kommission,371,56,,8,46,7,,427
3230,folketingsvalg,77,18,,6,13,3,,95
3231,https://t.co/UhYuvtaKuy,12,3,,1,12,3,,15
3232,Hoteller,13,3,,1,13,3,,16
3233,restaurant,150,17,,3,50,6,,167
3234,erhvervsaftale,13,3,,1,13,3,,16
3235,https://t.co/Rq5y7TLKOH,13,3,,1,13,3,,16
3236,Uforståeligt,2,3,,2,1,2,,5
3237,And,9,0,,2,4,0,,9
3238,Aftalen,136,22,,3,45,7,,158
3239,https://t.co/MCO1NltTLx,14,2,,1,14,2,,16
3240,orkestrering,0,0,,1,0,0,,0
3241,tonalitet,0,0,,1,0,0,,0
3242,særegen,0,0,,1,0,0,,0
3243,Gades,0,0,,1,0,0,,0
3244,tone,23,7,,7,3,1,,30
3245,europæisk,221,52,,8,28,6,,273
3246,stjerne,2,0,,2,1,0,,2
3247,Hartmann,0,0,,1,0,0,,0
3248,ditto,0,0,,1,0,0,,0
3249,ikke-følelse,0,0,,1,0,0,,0
3250,litteratur,0,0,,1,0,0,,0
3251,Brexit-fact,27,5,,1,27,5,,32
3252,https://t.co/421MMEgT7Q,27,5,,1,27,5,,32
3253,selvfedme,3,0,,1,3,0,,3
3254,kortsynethed,3,0,,1,3,0,,3
3255,pct.sparekrav,39,7,,1,39,7,,46
3256,burka-forbud,39,7,,1,39,7,,46
3257,burkaforbud,54,8,,2,27,4,,62
3258,WHO,297,22,,4,74,6,,319
3259,knæfald,21,0,,2,10,0,,21
3260,dollar,19,0,,1,19,0,,19
3261,Borgerliges,56,12,,3,19,4,,68
3262,bluffnummer,7,5,,1,7,5,,12
3263,Festlig,9,1,,1,9,1,,10
3264,fejring,9,1,,1,9,1,,10
3265,uafhængighedsdag,9,1,,1,9,1,,10
3266,Rydhave,9,1,,1,9,1,,10
3267,https://t.co/e76Ojzjqfp,9,1,,1,9,1,,10
3268,Eldrups,0,0,,1,0,0,,0
3269,interessant,55,7,,6,9,1,,62
3270,Bjarne,232,13,,5,46,3,,245
3271,Corydon,182,10,,3,61,3,,192
3272,løb,103,13,,6,17,2,,116
3273,ffdk,5,0,,2,2,0,,5
3274,nypaatwitter,2,0,,1,2,0,,2
3275,Mistanke,0,0,,1,0,0,,0
3276,fredsproces,16,3,,1,16,3,,19
3277,UAE,16,3,,1,16,3,,19
3278,Bahrain,16,3,,1,16,3,,19
3279,knytte,16,3,,1,16,3,,19
3280,diplomatisk,90,18,,2,45,9,,108
3281,Herligt,42,12,,2,21,6,,54
3282,rødes,29,11,,1,29,11,,40
3283,kørselsovervågning,29,11,,1,29,11,,40
3284,https://t.co/1nQuJyNYJH,29,11,,1,29,11,,40
3285,Gøteborg,38,18,,1,38,18,,56
3286,vejspærring,38,18,,1,38,18,,56
3287,diverse,38,18,,1,38,18,,56
3288,bilist,66,24,,2,33,12,,90
3289,Svensk,44,22,,2,22,11,,66
3290,magtmonopol,38,18,,1,38,18,,56
3291,svenskatweets,38,18,,1,38,18,,56
3292,https://t.co/hR2RFdjPJ8,38,18,,1,38,18,,56
3293,statslig,45,14,,8,6,2,,59
3294,Geodatastyrelsen,0,0,,1,0,0,,0
3295,mærke,17,3,,1,17,3,,20
3296,langsigtet,250,16,,5,50,3,,266
3297,strategi,173,15,,6,29,2,,188
3298,vinter,17,3,,2,8,2,,20
3299,forudsigelighed,17,3,,1,17,3,,20
3300,erhvervsliv,809,77,,20,40,4,,886
3301,årsmøde,26,8,,4,6,2,,34
3302,DFårsmøde16,3,0,,1,3,0,,3
3303,ultimativ,304,33,,4,76,8,,337
3304,blogindlæg,15,3,,1,15,3,,18
3305,undercover,15,3,,1,15,3,,18
3306,https://t.co/seB0lq6al3,15,3,,1,15,3,,18
3307,https://t.co/XZmDewrsPB,0,0,,1,0,0,,0
3308,frygtelig,24,8,,3,8,3,,32
3309,vanrøgt,47,10,,2,24,5,,57
3310,opmærksom,99,15,,11,9,1,,114
3311,dagligdag,83,19,,3,28,6,,102
3312,https://t.co/gViZaQVZW1,1,0,,1,1,0,,1
3313,uretmæssig,27,8,,1,27,8,,35
3314,nedlukning,359,50,,6,60,8,,409
3315,domstol,51,11,,4,13,3,,62
3316,marts,149,30,,8,19,4,,179
3317,kulturmin,23,1,,1,23,1,,24
3318,imorgen,88,11,,4,22,3,,99
3319,forsømme,37,3,,2,18,2,,40
3320,kulturliv,115,7,,2,58,4,,122
3321,udlændinge-delen,0,2,,1,0,2,,2
3322,suverænitetsoverdragelsen,0,2,,1,0,2,,2
3323,https://t.co/lhI2xWbO2S,26,9,,1,26,9,,35
3324,femteplads,5,1,,1,5,1,,6
3325,Henley,5,1,,1,5,1,,6
3326,Index,15,1,,2,8,0,,16
3327,Japan,5,1,,1,5,1,,6
3328,top,5,1,,1,5,1,,6
3329,list,53,5,,3,18,2,,58
3330,world's,5,1,,1,5,1,,6
3331,most,5,1,,1,5,1,,6
3332,powerful,5,1,,1,5,1,,6
3333,passports,5,1,,1,5,1,,6
3334,https://t.co/VJaAuUXKUC,5,1,,1,5,1,,6
3335,løse,131,19,,5,26,4,,150
3336,binde,741,69,,4,185,17,,810
3337,https://t.co/8wW7WSuJ4,42,6,,1,42,6,,48
3338,Lysfest,2,1,,1,2,1,,3
3339,Haderslev,2,1,,1,2,1,,3
3340,kaserne,7,3,,2,4,2,,10
3341,http://t.co/Qk4tdW6wNn,2,1,,1,2,1,,3
3342,Islam,1529,71,,5,306,14,,1600
3343,Korte,53,10,,1,53,10,,63
3344,Avis,54,10,,3,18,3,,64
3345,Jakob,106,12,,8,13,2,,118
3346,Notre,43,4,,1,43,4,,47
3347,Dame,43,4,,1,43,4,,47
3348,hjerte,461,42,,7,66,6,,503
3349,verdens-kulturarv,43,4,,1,43,4,,47
3350,fordums,43,4,,1,43,4,,47
3351,storhed,43,4,,1,43,4,,47
3352,NotreDame,43,4,,1,43,4,,47
3353,døgnrapport,0,0,,1,0,0,,0
3354,https://t.co/mJCrDTYdKN,0,0,,1,0,0,,0
3355,racisme,643,76,,8,80,10,,719
3356,ofre,394,39,,7,56,6,,433
3357,massevoldtægt,92,16,,1,92,16,,108
3358,uhyrlighed,92,16,,1,92,16,,108
3359,afstamning,92,16,,1,92,16,,108
3360,luder,92,16,,1,92,16,,108
3361,hadtildanskere,92,16,,1,92,16,,108
3362,https://t.co/oa6Bcyisd0,92,16,,1,92,16,,108
3363,forfærdelig,897,105,,6,150,18,,1002
3364,sygdom,334,36,,10,33,4,,370
3365,sklerose,25,2,,1,25,2,,27
3366,sundhedspersonale,70,7,,3,23,2,,77
3367,træningscenter,25,2,,1,25,2,,27
3368,opmærksomhed,305,35,,8,38,4,,340
3369,https://t.co/I006s3HzBQ,25,2,,1,25,2,,27
3370,bolle,27,4,,1,27,4,,31
3371,https://t.co/MvFPoMc8i8,27,4,,1,27,4,,31
3372,Lovforslaget,1,0,,1,1,0,,1
3373,samling,1,0,,1,1,0,,1
3374,realistisk,66,13,,4,16,3,,79
3375,Planen,36,11,,1,36,11,,47
3376,Schengen,36,11,,1,36,11,,47
3377,reformation,36,11,,1,36,11,,47
3378,https://t.co/Zr78Mo2m6c,36,11,,1,36,11,,47
3379,Delaftale,23,6,,1,23,6,,29
3380,Indeholder,23,6,,1,23,6,,29
3381,børneområde,50,7,,2,25,4,,57
3382,bekostning,94,22,,3,31,7,,116
3383,oversælger,23,6,,1,23,6,,29
3384,Uenige,28,19,,1,28,19,,47
3385,opfordre,54,22,,2,27,11,,76
3386,opstillingsberettigelse,28,19,,1,28,19,,47
3387,nytårskur,44,13,,2,22,6,,57
3388,Rederier,17,3,,1,17,3,,20
3389,søfartsnation,17,3,,1,17,3,,20
3390,https://t.co/VYRdgHJOmd,17,3,,1,17,3,,20
3391,sas,0,0,,1,0,0,,0
3392,besætning,23,1,,3,8,0,,24
3393,cphairport,0,0,,1,0,0,,0
3394,Tibet-kommission,32,6,,1,32,6,,38
3395,Tingene,32,6,,2,16,3,,38
3396,opsige,2,2,,1,2,2,,4
3397,FN-konvention,2,2,,1,2,2,,4
3398,statsløshed,2,2,,1,2,2,,4
3399,https://t.co/66evWeDFYu,2,2,,1,2,2,,4
3400,10.,39,5,,4,10,1,,44
3401,ungdomsår,27,2,,1,27,2,,29
3402,VIVEs,27,2,,1,27,2,,29
3403,rapport,245,33,,14,18,2,,278
3404,efterværn,27,2,,1,27,2,,29
3405,voksenliv,27,2,,1,27,2,,29
3406,kølig,18,2,,1,18,2,,20
3407,overblik,18,2,,1,18,2,,20
3408,https://t.co/YCNT6iCAT9,18,2,,1,18,2,,20
3409,holdningsuenighed,2,0,,1,2,0,,2
3410,Politikere,10,3,,2,5,2,,13
3411,ramme,518,18,,11,47,2,,536
3412,service,347,36,,12,29,3,,383
3413,frustration,111,24,,4,28,6,,135
3414,COVID19,422,85,,7,60,12,,507
3415,valgløfte,50,7,,4,12,2,,57
3416,ft15,3,3,,1,3,3,,6
3417,nuloverdeigen,3,3,,1,3,3,,6
3418,https://t.co/489OmCox2Y,3,3,,1,3,3,,6
3419,Opdaterer,6,1,,1,6,1,,7
3420,kalender,6,1,,1,6,1,,7
3421,Thorningmåvidere,6,1,,1,6,1,,7
3422,ftvalg15,11,3,,4,3,1,,14
3423,http://t.co/zXiuKxEiIJ,6,1,,1,6,1,,7
3424,https://t.co/U4XzhgJtGp,22,6,,1,22,6,,28
3425,øje,1354,81,,15,90,5,,1435
3426,åbne,146,8,,4,36,2,,154
3427,https://t.co/JFpa8D0nQ6,1,0,,1,1,0,,1
3428,argumentere,131,17,,2,66,8,,148
3429,Kolde,5,1,,1,5,1,,6
3430,tilsvining,5,1,,1,5,1,,6
3431,offer,23,2,,3,8,1,,25
3432,rusland,5,1,,1,5,1,,6
3433,løft,322,60,,9,36,7,,382
3434,kvalitetssikring,27,1,,1,27,1,,28
3435,pct,21,4,,7,3,1,,25
3436,Sverigedemokraterna,0,1,,1,0,1,,1
3437,meningsmåling,12,1,,2,6,0,,13
3438,Svenskerne,0,1,,1,0,1,,1
3439,islamister,204,35,,4,51,9,,239
3440,sætte,107,20,,1,107,20,,127
3441,asylstoppet,107,20,,1,107,20,,127
3442,hjemsendelse,107,20,,1,107,20,,127
3443,https://t.co/ZNEWFTTefY,107,20,,1,107,20,,127
3444,.@Heunicke,10,6,,1,10,6,,16
3445,rådgiver,10,6,,1,10,6,,16
3446,reaktion,1440,1117,,10,144,112,,2557
3447,http://t.co/dVnnTCLT54,10,6,,1,10,6,,16
3448,uafhængig,756,30,,3,252,10,,786
3449,forfatningsråd,2,0,,1,2,0,,2
3450,http://t.co/6H3NDWAcy0,2,0,,1,2,0,,2
3451,stenkaster,0,0,,1,0,0,,0
3452,https://t.co/DFuEZtSyce,0,0,,1,0,0,,0
3453,Twitter,220,11,,12,18,1,,231
3454,Matador,5,0,,1,5,0,,5
3455,tilbøjelig,5,0,,1,5,0,,5
3456,husktag,5,0,,1,5,0,,5
3457,ironi,73,1,,3,24,0,,74
3458,kedelig,12,2,,1,12,2,,14
3459,ren,1022,98,,18,57,5,,1120
3460,valgflæsk,12,2,,1,12,2,,14
3461,frømand,46,6,,1,46,6,,52
3462,kavaler,46,6,,1,46,6,,52
3463,omsorgsfuld,46,6,,1,46,6,,52
3464,far,1047,55,,11,95,5,,1102
3465,arvtager,46,6,,1,46,6,,52
3466,Kongeriget,46,6,,1,46,6,,52
3467,HKH,97,15,,2,48,8,,112
3468,Kronprins,46,6,,1,46,6,,52
3469,Frederik50,46,6,,1,46,6,,52
3470,tillykkemedfødselsdagen,46,6,,1,46,6,,52
3471,Foto,74,16,,3,25,5,,90
3472,Steen,53,6,,2,26,3,,59
3473,Ewald,46,6,,1,46,6,,52
3474,https://t.co/TUIByU54vq,46,6,,1,46,6,,52
3475,Muslimske,1,2,,1,1,2,,3
3476,etnisk,111,31,,6,18,5,,142
3477,undertrykkelse,82,16,,7,12,2,,98
3478,ishockey,13,2,,1,13,2,,15
3479,bedrift,16,2,,2,8,1,,18
3480,oplevelse,237,23,,8,30,3,,260
3481,vente,23,2,,2,12,1,,25
3482,billettere,13,2,,1,13,2,,15
3483,DANMARK,13,2,,1,13,2,,15
3484,VMIshockey,13,2,,1,13,2,,15
3485,Copenhagen,16,3,,2,8,2,,19
3486,https://t.co/5pa0jjZwkD,13,2,,1,13,2,,15
3487,MeToo,40,1,,2,20,0,,41
3488,igår,141,8,,6,24,1,,149
3489,studievært,37,1,,1,37,1,,38
3490,bal,37,1,,1,37,1,,38
3491,sart,37,1,,1,37,1,,38
3492,smertefri,37,1,,1,37,1,,38
3493,Interviewet,37,1,,1,37,1,,38
3494,https://t.co/ueEhcZQA3y,37,1,,1,37,1,,38
3495,Etnisk,55,10,,1,55,10,,65
3496,indsætte,110,19,,3,37,6,,129
3497,undertal,55,10,,1,55,10,,65
3498,fængsle,116,19,,3,39,6,,135
3499,https://t.co/IBFwrUvNRS,55,10,,1,55,10,,65
3500,https://t.co/l8y0KlRwoa,2,0,,1,2,0,,2
3501,https://t.co/ABXUTagnFd,2,0,,1,2,0,,2
3502,Reformpædagogikken,6,1,,1,6,1,,7
3503,Gymnasiet,149,4,,2,74,2,,153
3504,kundskabsskole,6,1,,1,6,1,,7
3505,grundvand,0,0,,1,0,0,,0
3506,coronatiden,23,1,,1,23,1,,24
3507,generel,98,8,,9,11,1,,106
3508,https://t.co/GBWiGUrsLp,23,1,,1,23,1,,24
3509,Grundtvig,31,5,,2,16,2,,36
3510,stå,40,12,,2,20,6,,52
3511,https://t.co/hyuIMhf5VZ,8,2,,1,8,2,,10
3512,Trudeau,37,4,,1,37,4,,41
3513,morgen,1108,83,,24,46,3,,1191
3514,https://t.co/q5UBjMWMTn,0,0,,1,0,0,,0
3515,coronavirus,54,6,,3,18,2,,60
3516,inklusion,5,0,,2,2,0,,5
3517,tilstrækkelig,7,0,,2,4,0,,7
3518,Fokus,390,27,,2,195,14,,417
3519,kvantitet,2,0,,1,2,0,,2
3520,debattere,90,15,,11,8,1,,105
3521,https://t.co/bjzMJZP9nf,4,0,,1,4,0,,4
3522,landsråd,224,15,,4,56,4,,239
3523,synspunkt,728,57,,9,81,6,,785
3524,formiddag,115,17,,4,29,4,,132
3525,opløsning,16,2,,1,16,2,,18
3526,krimi,2,0,,2,1,0,,2
3527,læsetimer,1,0,,1,1,0,,1
3528,fix,3,0,,2,2,0,,3
3529,retsstat,1307,79,,8,163,10,,1386
3530,utopi,1,0,,1,1,0,,1
3531,Forhandlinger,25,12,,2,12,6,,37
3532,socialtilsyn,10,8,,1,10,8,,18
3533,Nuværende,10,8,,1,10,8,,18
3534,tilsyn,22,18,,3,7,6,,40
3535,grundlægge,10,8,,1,10,8,,18
3536,skarp,358,39,,9,40,4,,397
3537,Hjorthøjgaardsagen,10,8,,1,10,8,,18
3538,driftsoverenskomst,10,8,,1,10,8,,18
3539,https://t.co/SnhYcAdUkE,10,8,,1,10,8,,18
3540,simpel,347,47,,8,43,6,,394
3541,skift,12,3,,3,4,1,,15
3542,paneldebat,2,0,,1,2,0,,2
3543,Nordsjælland,11,3,,3,4,1,,14
3544,rockstjerne,2,0,,1,2,0,,2
3545,Paneldebat,21,2,,1,21,2,,23
3546,inspiration,569,38,,4,142,10,,607
3547,handicappolitisk,21,2,,1,21,2,,23
3548,handicappol,21,2,,1,21,2,,23
3549,måne,93,5,,5,19,1,,98
3550,Konservative,386,11,,9,43,1,,397
3551,Landsråd,30,1,,1,30,1,,31
3552,virtuel,30,1,,1,30,1,,31
3553,Svær,44,3,,2,22,2,,47
3554,hovedrolleindehaveren,5,2,,1,5,2,,7
3555,statsløse-skandalen,5,2,,1,5,2,,7
3556,https://t.co/GrDkZKVUVn,5,2,,1,5,2,,7
3557,sludder,40,1,,2,20,0,,41
3558,symbolik,23,1,,1,23,1,,24
3559,lønmodtager,285,46,,10,28,5,,331
3560,ende,280,44,,4,70,11,,324
3561,briefing,115,6,,1,115,6,,121
3562,Heunicke,131,7,,2,66,4,,138
3563,Hækkerup,204,11,,3,68,4,,215
3564,Brostrøm,126,8,,2,63,4,,134
3565,Mølbak,208,13,,3,69,4,,221
3566,smitttetal,115,6,,1,115,6,,121
3567,Restriktioner,115,6,,1,115,6,,121
3568,Martin,20,5,,5,4,1,,25
3569,Luther,12,1,,2,6,0,,13
3570,King,25,11,,3,8,4,,36
3571,boykotte,9,1,,2,4,0,,10
3572,ukorrekt,8,0,,1,8,0,,8
3573,https://t.co/hUt8moQ8iX,8,0,,1,8,0,,8
3574,:-),37,6,,11,3,1,,43
3575,ejendomligt,2,0,,1,2,0,,2
3576,global,737,169,,11,67,15,,906
3577,lederskab,32,4,,2,16,2,,36
3578,Covfefe,31,4,,1,31,4,,35
3579,skat,39,6,,3,13,2,,45
3580,Aktiekursen,0,0,,1,0,0,,0
3581,https://t.co/u3P5Ck7ES0,2,0,,1,2,0,,2
3582,ENVISION,1,4,,1,1,4,,5
3583,REKLAMEBUREAU,1,4,,1,1,4,,5
3584,SØGER,1,4,,1,1,4,,5
3585,PRAKTIKANTER,1,4,,1,1,4,,5
3586,FORÅRET,1,4,,1,1,4,,5
3587,Opslag,1,4,,1,1,4,,5
3588,envision,1,4,,1,1,4,,5
3589,A/S,1,4,,1,1,4,,5
3590,uskyldighed,38,1,,1,38,1,,39
3591,saglig,39,1,,2,20,0,,40
3592,sober,39,1,,2,20,0,,40
3593,rygklapper,38,1,,1,38,1,,39
3594,mill,1,2,,2,0,1,,3
3595,lærer,357,61,,10,36,6,,418
3596,stift,13,3,,5,3,1,,16
3597,slotsplads,55,6,,1,55,6,,61
3598,type,147,14,,7,21,2,,161
3599,ryge,55,6,,1,55,6,,61
3600,smøg,75,7,,2,38,4,,82
3601,ond,58,6,,3,19,2,,64
3602,skolestrejke,55,6,,1,55,6,,61
3603,metodefrihed,0,1,,1,0,1,,1
3604,skærmtid,0,1,,1,0,1,,1
3605,nedmedskuldrene,0,1,,1,0,1,,1
3606,Rolig,1,0,,2,0,0,,1
3607,Dagen,604,46,,4,151,12,,650
3608,regn,63,1,,2,32,0,,64
3609,https://t.co/YctpJOUmDD,0,0,,1,0,0,,0
3610,generationsskiftebeskatning,58,6,,1,58,6,,64
3611,beskatning,80,7,,4,20,2,,87
3612,https://t.co/UZGD40jC4,58,6,,1,58,6,,64
3613,ADGANGSKONTROL,1,1,,1,1,1,,2
3614,HOSPITALER,1,1,,1,1,1,,2
3615,affaldsindsamling,14,1,,1,14,1,,15
3616,benhård,14,1,,1,14,1,,15
3617,cigaretskodder,14,1,,1,14,1,,15
3618,forældreansvar,4,2,,1,4,2,,6
3619,veludhvilet,4,2,,1,4,2,,6
3620,undervisningsparate,4,2,,1,4,2,,6
3621,fraværstal,4,2,,1,4,2,,6
3622,parallelsamfundsaften,4,2,,1,4,2,,6
3623,https://t.co/KVH4VZZUqM,4,2,,1,4,2,,6
3624,lovhjemmel,554,34,,4,138,8,,588
3625,aflivning,777,43,,4,194,11,,820
3626,TV2News,11,0,,1,11,0,,11
3627,Børsens,11,0,,1,11,0,,11
3628,forside,60,1,,4,15,0,,61
3629,bonus,53,2,,3,18,1,,55
3630,Nets,11,0,,1,11,0,,11
3631,usynlig,11,0,,1,11,0,,11
3632,Götz,11,0,,1,11,0,,11
3633,kunde,453,25,,5,91,5,,478
3634,Nedslidning,1,0,,1,1,0,,1
3635,seniorpension,1,0,,1,1,0,,1
3636,overførselsindkomst,6,1,,3,2,0,,7
3637,herom,564,22,,4,141,6,,586
3638,Bandekonflikter,17,3,,1,17,3,,20
3639,hensynsløs,17,3,,1,17,3,,20
3640,årsværk,17,3,,1,17,3,,20
3641,synlig,17,3,,1,17,3,,20
3642,https://t.co/ZQBsFs9Gph,17,3,,1,17,3,,20
3643,fht,3,0,,1,3,0,,3
3644,fastholdelsesgrad,3,0,,1,3,0,,3
3645,ingeniør,3,0,,1,3,0,,3
3646,Fantomskat,27,3,,1,27,3,,30
3647,symptom,27,3,,1,27,3,,30
3648,fantasi,28,4,,2,14,2,,32
3649,benspænd,27,3,,1,27,3,,30
3650,iværksætter,127,13,,3,42,4,,140
3651,biotek,27,3,,1,27,3,,30
3652,knop,27,3,,1,27,3,,30
3653,beslutningsforslag,225,26,,7,32,4,,251
3654,fantomskatten,27,3,,1,27,3,,30
3655,https://t.co/iZPmE3GALm,27,3,,1,27,3,,30
3656,skoletid,149,15,,7,21,2,,164
3657,ungekrim,5,0,,1,5,0,,5
3658,rest,611,82,,16,38,5,,693
3659,venstrefløj,1966,169,,15,131,11,,2135
3660,forpligtelse,28,0,,2,14,0,,28
3661,rør,0,0,,1,0,0,,0
3662,rædselsfuld,10,2,,2,5,1,,12
3663,evighed,18,1,,2,9,0,,19
3664,Røgfri,5,0,,1,5,0,,5
3665,ryger,29,1,,2,14,0,,30
3666,røgfri,128,12,,4,32,3,,140
3667,kristendom,7,2,,2,4,1,,9
3668,islam,522,85,,3,174,28,,607
3669,Rod,11,1,,1,11,1,,12
3670,mailsystem,11,1,,1,11,1,,12
3671,fødevareminister,11,1,,1,11,1,,12
3672,minkavler,1056,45,,6,176,8,,1101
3673,nedslagtning,111,1,,2,56,0,,112
3674,Ditte,2,0,,1,2,0,,2
3675,Virkelig,8,1,,1,8,1,,9
3676,lettelse,53,9,,6,9,2,,62
3677,ubærlig,8,1,,1,8,1,,9
3678,udlændige,55,5,,3,18,2,,60
3679,automat,1,0,,1,1,0,,1
3680,Partiledere,31,15,,1,31,15,,46
3681,https://t.co/v60pJlCO6p,31,15,,1,31,15,,46
3682,Metal,2,0,,1,2,0,,2
3683,Vermund,634,62,,8,79,8,,696
3684,Hizb,248,19,,1,248,19,,267
3685,ut-Tahrir,248,19,,1,248,19,,267
3686,Juleaften,1,1,,1,1,1,,2
3687,farvel,333,33,,5,67,7,,366
3688,brite,1,1,,1,1,1,,2
3689,handelsrelation,1,1,,1,1,1,,2
3690,Goodbye,1,1,,1,1,1,,2
3691,Britannia,1,1,,1,1,1,,2
3692,BrexitDeal,1,1,,1,1,1,,2
3693,https://t.co/AurDsVOEXA,1,1,,1,1,1,,2
3694,dælen,2,0,,1,2,0,,2
3695,ulogisk,2,0,,1,2,0,,2
3696,hverv,2,0,,2,1,0,,2
3697,deromkring,2,0,,1,2,0,,2
3698,antydning,2,0,,1,2,0,,2
3699,faglighed,107,22,,7,15,3,,129
3700,regnestykke,7,2,,1,7,2,,9
3701,matematik,7,2,,1,7,2,,9
3702,EM-plet,1,0,,1,1,0,,1
3703,hjem,94,24,,6,16,4,,118
3704,https://t.co/oYribjOCD0,1,0,,1,1,0,,1
3705,Uenighederne,0,0,,1,0,0,,0
3706,tempo,5,2,,3,2,1,,7
3707,kvindekonference,6,1,,1,6,1,,7
3708,Oplæg,6,1,,1,6,1,,7
3709,bla,36,6,,8,4,1,,42
3710,Nader,6,1,,1,6,1,,7
3711,Nyidentitet,6,1,,1,6,1,,7
3712,undertrykke,6,1,,1,6,1,,7
3713,samtlige,389,37,,8,49,5,,426
3714,Excitcirkel,6,1,,1,6,1,,7
3715,ære,16,3,,5,3,1,,19
3716,https://t.co/gXiRa3UYn4,6,1,,1,6,1,,7
3717,median-IQ,11,0,,1,11,0,,11
3718,http://t.co/ouXgiVepY8,6,5,,1,6,5,,11
3719,måling,367,13,,5,73,3,,380
3720,Gallup,313,6,,1,313,6,,319
3721,https://t.co/csUmgiPDu2,313,6,,1,313,6,,319
3722,Hovedstaden,32,3,,2,16,2,,35
3723,Øresundsregionen,3,1,,1,3,1,,4
3724,GreaterCopenhagen,3,1,,1,3,1,,4
3725,potentiale,3,1,,1,3,1,,4
3726,smart,3,1,,1,3,1,,4
3727,fyrtårnsprojekter,3,1,,1,3,1,,4
3728,P2X,3,1,,1,3,1,,4
3729,orsted,3,1,,1,3,1,,4
3730,https://t.co/GSbH2Ctk4H,3,1,,1,3,1,,4
3731,Åhh,1,0,,1,1,0,,1
3732,datter,324,10,,8,40,1,,334
3733,Maradona,83,3,,1,83,3,,86
3734,80'erne,83,3,,1,83,3,,86
3735,10'erne,83,3,,1,83,3,,86
3736,ubestridt,83,3,,1,83,3,,86
3737,https://t.co/jkXtiBnUFO,83,3,,1,83,3,,86
3738,dumhed,2,0,,1,2,0,,2
3739,videomødet,379,1,,1,379,1,,380
3740,proppe,379,1,,1,379,1,,380
3741,sutte,379,1,,1,379,1,,380
3742,flække,379,1,,1,379,1,,380
3743,coronatimes,379,1,,1,379,1,,380
3744,savnerchristiansborg,379,1,,1,379,1,,380
3745,https://t.co/oV4khnvPvT,379,1,,1,379,1,,380
3746,Tallet,3,0,,1,3,0,,3
3747,følgeerhverv,3,0,,1,3,0,,3
3748,sammenhængsreform,107,20,,2,54,10,,127
3749,Marienborg,46,7,,2,23,4,,53
3750,sidekammerat,465,28,,2,232,14,,493
3751,reg.,3,0,,1,3,0,,3
3752,umulig,93,5,,4,23,1,,98
3753,kår,0,0,,1,0,0,,0
3754,indbrud,0,0,,1,0,0,,0
3755,ressource,159,31,,15,11,2,,190
3756,Mckinsey,0,0,,1,0,0,,0
3757,betjent,266,31,,10,27,3,,297
3758,overnatning,1,0,,1,1,0,,1
3759,Haha,106,2,,12,9,0,,108
3760,https://t.co/xq4FCGAu7i,74,1,,1,74,1,,75
3761,Velfortjent,36,1,,2,18,0,,37
3762,Pyhhh,34,2,,1,34,2,,36
3763,Forhandling,34,2,,1,34,2,,36
3764,kompensation,40,3,,2,20,2,,43
3765,ekspropriere,34,2,,1,34,2,,36
3766,modstander,120,14,,9,13,2,,134
3767,Jan.,1,0,,1,1,0,,1
3768,folkestyre,280,11,,4,70,3,,291
3769,ekspertstyre,4,1,,1,4,1,,5
3770,kommunalpolitiker,7,0,,1,7,0,,7
3771,folketingsgruppe,7,0,,2,4,0,,7
3772,kaotisk,7,0,,1,7,0,,7
3773,diskussion,188,28,,12,16,2,,216
3774,beløbsgrænse,7,0,,2,4,0,,7
3775,sur,109,14,,6,18,2,,123
3776,NorthUltras,2,0,,1,2,0,,2
3777,esport,2,0,,1,2,0,,2
3778,Udsultet,3,0,,1,3,0,,3
3779,redskab,189,14,,6,32,2,,203
3780,rådighed,54,12,,5,11,2,,66
3781,undersøgelsesformer,30,2,,1,30,2,,32
3782,belejlig,135,14,,2,68,7,,149
3783,https://t.co/BEY1k06nLG,30,2,,1,30,2,,32
3784,hjørne,2,0,,1,2,0,,2
3785,kæphest,2,0,,1,2,0,,2
3786,dom,767,566,,10,77,57,,1333
3787,Problemet,6,2,,5,1,0,,8
3788,pædagogisk,2,0,,1,2,0,,2
3789,spisning,3,1,,1,3,1,,4
3790,tech-områder,13,4,,1,13,4,,17
3791,tilgang,48,6,,6,8,1,,54
3792,satsning,13,4,,1,13,4,,17
3793,https://t.co/hLAX4hdRc9,13,4,,1,13,4,,17
3794,Lavere,340,29,,4,85,7,,369
3795,hemmelighed,1,0,,1,1,0,,1
3796,skattetryk,1,0,,1,1,0,,1
3797,overfortolke,0,0,,1,0,0,,0
3798,ændring,206,24,,10,21,2,,230
3799,ift,43,5,,7,6,1,,48
3800,lektiecaféer,0,0,,1,0,0,,0
3801,varm,25,4,,3,8,1,,29
3802,https://t.co/pgu3ilBE0R,6,1,,1,6,1,,7
3803,Klart,26,0,,1,26,0,,26
3804,Idiotisk,26,0,,1,26,0,,26
3805,sindssyg,156,29,,3,52,10,,185
3806,klassisk,26,0,,1,26,0,,26
3807,Forsigtig,144,8,,1,144,8,,152
3808,optimisme,149,10,,2,74,5,,159
3809,Vrøvl,31,1,,3,10,0,,32
3810,terror,817,120,,10,82,12,,937
3811,dræbe,20,2,,3,7,1,,22
3812,uoverensstemmelse,0,0,,1,0,0,,0
3813,liiige,16,2,,1,16,2,,18
3814,hastebehandling,16,2,,1,16,2,,18
3815,boligaftalen,23,3,,3,8,1,,26
3816,Jeres,23,3,,1,23,3,,26
3817,selvevaluering,23,3,,1,23,3,,26
3818,nuance,30,6,,3,10,2,,36
3819,https://t.co/m72X50BuwV,23,3,,1,23,3,,26
3820,Barnets,61,10,,2,30,5,,71
3821,socialrådgiver,221,26,,6,37,4,,247
3822,situation,444,87,,18,25,5,,531
3823,⁦@TrineTorp⁩,10,1,,1,10,1,,11
3824,amp,539,169,,22,24,8,,708
3825,⁦@JerkelK⁩,10,1,,1,10,1,,11
3826,https://t.co/SI9GrZwAw4,10,1,,1,10,1,,11
3827,Besøgte,90,17,,2,45,8,,107
3828,Malmøgade,11,2,,1,11,2,,13
3829,aarhus,13,4,,8,2,0,,17
3830,drøftelse,126,14,,4,32,4,,140
3831,https://t.co/G1mEDOL6Nz,11,2,,1,11,2,,13
3832,https://t.co/QLG93ymXSR,1,0,,1,1,0,,1
3833,maske,3,0,,1,3,0,,3
3834,udskamning,96,0,,1,96,0,,96
3835,Hahaha,2,0,,3,1,0,,2
3836,bistand,5,8,,2,2,4,,13
3837,sexisme,26,4,,2,13,2,,30
3838,envisiondk,1,0,,1,1,0,,1
3839,Masser,5,0,,1,5,0,,5
3840,Dannebrog,7,1,,1,7,1,,8
3841,Rigsfællesskabets,7,1,,1,7,1,,8
3842,flag,34,3,,4,8,1,,37
3843,Rigsfællesskabet,120,35,,3,40,12,,155
3844,myndighed,290,41,,16,18,3,,331
3845,selvstyre,95,22,,2,48,11,,117
3846,fordrukken,37,1,,1,37,1,,38
3847,suveræn,41,1,,2,20,0,,42
3848,uvildig,110,4,,3,37,1,,114
3849,Broderparten,15,0,,1,15,0,,15
3850,bitterhed,15,0,,1,15,0,,15
3851,afslag,22,2,,2,11,1,,24
3852,Finansministeriets,15,0,,1,15,0,,15
3853,https://t.co/uMvvkFdhvq,15,0,,1,15,0,,15
3854,Historien,53,4,,1,53,4,,57
3855,tydelig,174,20,,7,25,3,,194
3856,sprog,695,64,,8,87,8,,759
3857,Demokrater,53,4,,1,53,4,,57
3858,Republikanere,53,4,,1,53,4,,57
3859,Flaskeposten,14,0,,1,14,0,,14
3860,juraprofessor,14,0,,1,14,0,,14
3861,Engell,9,0,,1,9,0,,9
3862,sikker,713,28,,11,65,3,,741
3863,folketingspolitiker,8,2,,2,4,1,,10
3864,Erhverv,1,0,,1,1,0,,1
3865,invitere,11,7,,2,6,4,,18
3866,Havn,1,0,,1,1,0,,1
3867,https://t.co/uFnoAbNuYd,1,0,,1,1,0,,1
3868,magtmisbrug,474,30,,4,118,8,,504
3869,Krag,332,24,,2,166,12,,356
3870,valgkreds,317,25,,2,158,12,,342
3871,Køge,316,25,,2,158,12,,341
3872,Vestegnen,324,24,,2,162,12,,348
3873,Høje,346,24,,2,173,12,,370
3874,Taastrup,346,24,,2,173,12,,370
3875,Ulækkert,315,24,,1,315,24,,339
3876,https://t.co/YWpExkCktA,315,24,,1,315,24,,339
3877,rockerrenter,1,0,,1,1,0,,1
3878,stede,1,0,,1,1,0,,1
3879,lån,57,4,,6,10,1,,61
3880,ÅOP,1,0,,1,1,0,,1
3881,Assistens,38,1,,1,38,1,,39
3882,Kirkegård,38,1,,1,38,1,,39
3883,afstand,2278,146,,18,127,8,,2424
3884,justitsminister,220,31,,8,28,4,,251
3885,præsentation,85,12,,2,42,6,,97
3886,politistation,130,20,,3,43,7,,150
3887,https://t.co/pNzifktaqd,50,3,,1,50,3,,53
3888,drøm,67,17,,6,11,3,,84
3889,sundhedsreform,99,20,,5,20,4,,119
3890,pris,419,60,,22,19,3,,479
3891,Indkald,8,2,,1,8,2,,10
3892,https://t.co/Jx9MozUIRU,8,2,,1,8,2,,10
3893,nøjagtig,19,14,,4,5,4,,33
3894,irettesættelse,46,2,,1,46,2,,48
3895,lejemarkedet,1,0,,1,1,0,,1
3896,andelsbolig,41,10,,4,10,2,,51
3897,Vækstteamet,6,0,,1,6,0,,6
3898,larsloekke,2,0,,1,2,0,,2
3899,årsdag16,2,0,,1,2,0,,2
3900,synd,29,0,,4,7,0,,29
3901,kundeservice,24,3,,1,24,3,,27
3902,erhvervsafdeling,24,3,,1,24,3,,27
3903,bitter,24,3,,1,24,3,,27
3904,udsigt,249,21,,6,42,4,,270
3905,Børn,826,100,,12,69,8,,926
3906,https://t.co/VGAaMBosgh,20,3,,1,20,3,,23
3907,stråle,42,5,,1,42,5,,47
3908,pølse,123,12,,2,62,6,,135
3909,pandabjørn,42,5,,1,42,5,,47
3910,Laustsen,43,0,,1,43,0,,43
3911,gerning,43,0,,1,43,0,,43
3912,Manu,18,3,,1,18,3,,21
3913,Sareen,18,3,,1,18,3,,21
3914,Özlem,160,22,,5,32,4,,182
3915,Cekic,91,18,,3,30,6,,109
3916,gensyn,21,3,,2,10,2,,24
3917,EU-land,158,24,,3,53,8,,182
3918,Ønsketænkning,51,6,,1,51,6,,57
3919,Carsten,50,13,,3,17,4,,63
3920,underbuks,7,1,,1,7,1,,8
3921,https://t.co/d1ts6cGFfi,7,1,,1,7,1,,8
3922,Megapinlig,5,2,,1,5,2,,7
3923,ubrugelig,5,2,,1,5,2,,7
3924,udstyr,5,2,,1,5,2,,7
3925,vupti,5,2,,1,5,2,,7
3926,respirator,5,2,,1,5,2,,7
3927,covid19,118,17,,5,24,3,,135
3928,https://t.co/yv4u4jBB7d,5,2,,1,5,2,,7
3929,NEWS,262,22,,1,262,22,,284
3930,opspore,262,22,,1,262,22,,284
3931,isolere,262,22,,1,262,22,,284
3932,behandle,262,22,,2,131,11,,284
3933,polarisere,3,0,,1,3,0,,3
3934,voldelig,13,2,,2,6,1,,15
3935,inkludere,9,2,,2,4,1,,11
3936,venstrefløjsaktivister,3,0,,1,3,0,,3
3937,radio,1,0,,1,1,0,,1
3938,24syv-agtigt,1,0,,1,1,0,,1
3939,Flygtningeordfører,1,0,,1,1,0,,1
3940,Rosa,1,0,,1,1,0,,1
3941,Lund,156,18,,4,39,4,,174
3942,morges,34,12,,3,11,4,,46
3943,flygtningekrisen,1,0,,1,1,0,,1
3944,syrisk,14,1,,3,5,0,,15
3945,borgerkrig,106,1,,2,53,0,,107
3946,ordfører,19,3,,5,4,1,,22
3947,højre,789,35,,5,158,7,,824
3948,ungdom,193,15,,2,96,8,,208
3949,journalisthøjskolen,14,2,,1,14,2,,16
3950,Bandekriminelle,76,12,,1,76,12,,88
3951,bandekriminalitet,76,12,,1,76,12,,88
3952,udelukkelse,76,12,,1,76,12,,88
3953,https://t.co/JnUYKZHr4L,76,12,,1,76,12,,88
3954,nem,755,42,,6,126,7,,797
3955,moralsk,31,0,,1,31,0,,31
3956,jura,5,0,,2,2,0,,5
3957,psyk,22,7,,3,7,2,,29
3958,statskundskab,5,0,,1,5,0,,5
3959,prestige,5,0,,1,5,0,,5
3960,pædagog,764,81,,14,55,6,,845
3961,arbejdsforhold,42,14,,3,14,5,,56
3962,https://t.co/K1tYyoM9Ps,5,0,,1,5,0,,5
3963,tillægspakke,185,76,,1,185,76,,261
3964,09.11.2001,29,5,,1,29,5,,34
3965,https://t.co/6J2g5WsZfC,29,5,,1,29,5,,34
3966,beregning,158,19,,6,26,3,,177
3967,punktform,88,8,,1,88,8,,96
3968,Wordformat,88,8,,1,88,8,,96
3969,Økonomer,88,8,,1,88,8,,96
3970,idrætsliv,33,1,,1,33,1,,34
3971,mave,85,6,,4,21,2,,91
3972,sektorpartnerskaberne,33,1,,1,33,1,,34
3973,https://t.co/3RSEM2VdKy,33,1,,1,33,1,,34
3974,kognitiv,6,3,,1,6,3,,9
3975,vanskelighed,6,3,,2,3,2,,9
3976,vedrøre,0,1,,1,0,1,,1
3977,inventar,0,1,,1,0,1,,1
3978,boligselskab,0,1,,1,0,1,,1
3979,OBO,0,1,,1,0,1,,1
3980,gide,88,3,,6,15,0,,91
3981,https://t.co/FEobFm2pki,5,0,,1,5,0,,5
3982,twitterbruger,1,0,,1,1,0,,1
3983,Påstande,7,0,,1,7,0,,7
3984,belæg,8,0,,3,3,0,,8
3985,fynsk,5,0,,1,5,0,,5
3986,brunsviger,5,0,,1,5,0,,5
3987,himmelhenrykt,5,0,,1,5,0,,5
3988,luksus,5,0,,1,5,0,,5
3989,creme,5,0,,1,5,0,,5
3990,brunsvigerambassadør,5,0,,1,5,0,,5
3991,handel,233,13,,1,233,13,,246
3992,Bladet,269,18,,5,54,4,,287
3993,skattefradrag,233,14,,2,116,7,,247
3994,terapi,63,1,,1,63,1,,64
3995,blæst,63,1,,1,63,1,,64
3996,traktordemo,63,1,,1,63,1,,64
3997,grundlov,162,20,,6,27,3,,182
3998,kønssygdom,63,1,,1,63,1,,64
3999,indblik,105,4,,1,105,4,,109
4000,professionel,133,6,,3,44,2,,139
4001,Tweet,50,2,,4,12,0,,52
4002,afvej,33,3,,2,16,2,,36
4003,hjemmeboende,12,0,,1,12,0,,12
4004,idiotisk,65,7,,2,32,4,,72
4005,tilskud,372,44,,8,46,6,,416
4006,moralisere,12,0,,1,12,0,,12
4007,bæredygtighed,14,0,,4,4,0,,14
4008,mærkesag,281,22,,2,140,11,,303
4009,https://t.co/oVGDMRmq6y,4,0,,1,4,0,,4
4010,Stærkere,136,9,,1,136,9,,145
4011,svin,143,10,,4,36,2,,153
4012,lang,574,53,,8,72,7,,627
4013,gennemtrænge,136,9,,1,136,9,,145
4014,klapsalve,136,9,,1,136,9,,145
4015,Fortjent,140,9,,2,70,4,,149
4016,Twitterlandet,105,7,,1,105,7,,112
4017,Zenia,105,7,,1,105,7,,112
4018,Stampe,108,7,,2,54,4,,115
4019,indkomst,163,19,,9,18,2,,182
4020,Stakkel,105,7,,1,105,7,,112
4021,samfundssind.#dkpol,105,7,,1,105,7,,112
4022,sympati,26,1,,4,6,0,,27
4023,venskabelig,14,0,,1,14,0,,14
4024,vant,30,3,,2,15,2,,33
4025,notat,54,6,,2,27,3,,60
4026,departementschef,0,0,,1,0,0,,0
4027,ringe,145,14,,3,48,5,,159
4028,kontor,25,1,,2,12,0,,26
4029,aflevere,0,0,,2,0,0,,0
4030,oplevelsesøkonomi,13,1,,1,13,1,,14
4031,udbetaling,854,36,,4,214,9,,890
4032,bane,239,26,,8,30,3,,265
4033,input,39,2,,6,6,0,,41
4034,ALT,29,5,,4,7,1,,34
4035,politikerlede,2,0,,1,2,0,,2
4036,bede,210,11,,2,105,6,,221
4037,selfie,164,3,,1,164,3,,167
4038,kamera,233,10,,5,47,2,,243
4039,dr1,164,3,,1,164,3,,167
4040,bareroligtalteklima,164,3,,1,164,3,,167
4041,https://t.co/SkULGNj6V8,164,3,,1,164,3,,167
4042,jernhård,8,2,,1,8,2,,10
4043,lady,8,2,,1,8,2,,10
4044,hovedtema,0,0,,1,0,0,,0
4045,http://t.co/Vf4aJcCQ4N,0,0,,1,0,0,,0
4046,tillidsmand,292,8,,1,292,8,,300
4047,vogte,292,8,,1,292,8,,300
4048,Klapsalverne,292,8,,1,292,8,,300
4049,Lokal,3,0,,1,3,0,,3
4050,tårnbykommune,3,0,,1,3,0,,3
4051,korrekt,45,8,,10,4,1,,53
4052,Højre,0,1,,1,0,1,,1
4053,grundlovsmøde,5,1,,2,2,0,,6
4054,http://t.co/cBtJnAFa5E,1,0,,1,1,0,,1
4055,ALTING,1,0,,1,1,0,,1
4056,DRs,1,0,,1,1,0,,1
4057,profl,1,0,,1,1,0,,1
4058,TV2OJ,1,0,,1,1,0,,1
4059,dilemma,52,2,,4,13,0,,54
4060,uansvarlig,1247,215,,10,125,22,,1462
4061,ansvarlighed,258,25,,4,64,6,,283
4062,velfærdsorgie,28,2,,1,28,2,,30
4063,Fantastiske,61,7,,3,20,2,,68
4064,Caroline,86,15,,2,43,8,,101
4065,https://t.co/G5kRPqPgMr,52,5,,1,52,5,,57
4066,Adsbøl,0,1,,1,0,1,,1
4067,fire,1,0,,1,1,0,,1
4068,slags,542,77,,16,34,5,,619
4069,søde,33,1,,6,6,0,,34
4070,Sikre,1,0,,1,1,0,,1
4071,Kritikken,93,7,,1,93,7,,100
4072,udligningsudspillet,93,7,,1,93,7,,100
4073,ulige,224,13,,2,112,6,,237
4074,please,93,7,,1,93,7,,100
4075,borgmester,171,33,,10,17,3,,204
4076,https://t.co/lYhh5pftlC,93,7,,1,93,7,,100
4077,stemning,13,2,,2,6,1,,15
4078,KV17,4,1,,1,4,1,,5
4079,godstemning,4,1,,1,4,1,,5
4080,https://t.co/9v8tRs788s,4,1,,1,4,1,,5
4081,tænker,3,0,,1,3,0,,3
4082,studierelevant,0,0,,1,0,0,,0
4083,semester,3,7,,2,2,4,,10
4084,opfordring,39,7,,4,10,2,,46
4085,sugardating,17,3,,1,17,3,,20
4086,SoMe,177,12,,3,59,4,,189
4087,internetkendis,17,3,,1,17,3,,20
4088,Fie,23,3,,2,12,2,,26
4089,Laursen,17,3,,1,17,3,,20
4090,influencere,17,3,,1,17,3,,20
4091,reklame,17,3,,1,17,3,,20
4092,salg,176,35,,6,29,6,,211
4093,seksuel,260,44,,6,43,7,,304
4094,mindreårig,46,5,,2,23,2,,51
4095,https://t.co/LY8iE0LNzw,17,3,,1,17,3,,20
4096,Forsvarsminister,0,0,,1,0,0,,0
4097,kapacitet,480,46,,8,60,6,,526
4098,folkemøde-deadline,13,1,,1,13,1,,14
4099,invitation,66,2,,3,22,1,,68
4100,Anerkender,15,1,,1,15,1,,16
4101,Bæredygtigt,15,1,,1,15,1,,16
4102,Landbrug,15,1,,1,15,1,,16
4103,kvælstofudledning,15,1,,1,15,1,,16
4104,vandmiljø,24,5,,2,12,2,,29
4105,biolog,15,1,,1,15,1,,16
4106,Grov,66,9,,1,66,9,,75
4107,pædofili,131,10,,2,66,5,,141
4108,https://t.co/j9TdTtiSd0,66,9,,1,66,9,,75
4109,Muhammedkrisen,7,3,,1,7,3,,10
4110,Ministeriet,40,9,,2,20,4,,49
4111,undervisningsforløb,7,3,,1,7,3,,10
4112,EMU,7,3,,1,7,3,,10
4113,torsdag,418,30,,6,70,5,,448
4114,magthaver,21,1,,2,10,0,,22
4115,øst,4,1,,2,2,0,,5
4116,vest,40,5,,5,8,1,,45
4117,Gentofte,2,0,,2,1,0,,2
4118,detaljere,166,9,,4,42,2,,175
4119,almen,81,9,,8,10,1,,90
4120,enkel,581,32,,2,290,16,,613
4121,adgang,714,73,,20,36,4,,787
4122,lægevagt,2,0,,1,2,0,,2
4123,telefonnummer,2,0,,1,2,0,,2
4124,https://t.co/5ZnF66e9hY,2,0,,1,2,0,,2
4125,kompliment,567,19,,2,284,10,,586
4126,sexistisk,547,19,,1,547,19,,566
4127,knastør,547,19,,1,547,19,,566
4128,trusse,547,19,,1,547,19,,566
4129,Frederiksberg,1,0,,1,1,0,,1
4130,veldrevet,1,0,,1,1,0,,1
4131,Effektiviseret,1,0,,1,1,0,,1
4132,Hovedstadsborgmester,1,0,,1,1,0,,1
4133,udligningsplan,1,0,,1,1,0,,1
4134,dummebøde,1,0,,1,1,0,,1
4135,https://t.co/NXFVzsMxb4,1,0,,1,1,0,,1
4136,Argument,23,7,,1,23,7,,30
4137,Malaysia,3,1,,1,3,1,,4
4138,https://t.co/BTrA6DP6GR,3,1,,1,3,1,,4
4139,perfekt,36,3,,6,6,0,,39
4140,korrespondencen,1,0,,1,1,0,,1
4141,tippe,6,0,,4,2,0,,6
4142,Demokrati,1,0,,2,0,0,,1
4143,Villabyerne,1,0,,1,1,0,,1
4144,https://t.co/hg2eQ94zIJ,1,0,,1,1,0,,1
4145,pladsmangel,0,0,,1,0,0,,0
4146,aldrigset,0,0,,1,0,0,,0
4147,uenighed,7,2,,3,2,1,,9
4148,demonstration,43,7,,2,22,4,,50
4149,øjenene,27,6,,1,27,6,,33
4150,https://t.co/P9vlzhd6Si,27,6,,1,27,6,,33
4151,usikkerhed,113,13,,4,28,3,,126
4152,ufaglært,80,16,,4,20,4,,96
4153,svække,29,7,,1,29,7,,36
4154,lavtlønsjob,29,7,,1,29,7,,36
4155,dkøko,130,24,,4,32,6,,154
4156,https://t.co/Nk7Jv3wJDD,29,7,,1,29,7,,36
4157,Google,0,0,,1,0,0,,0
4158,hyperemesis,0,0,,1,0,0,,0
4159,Sænk,22,2,,3,7,1,,24
4160,Millionærskat,22,1,,1,22,1,,23
4161,håndsrækning,5,1,,1,5,1,,6
4162,komplicere,3,0,,2,2,0,,3
4163,cigaret,46,8,,2,23,4,,54
4164,https://t.co/QueGNssYl0,28,7,,1,28,7,,35
4165,dagtilbudsområde,0,0,,1,0,0,,0
4166,leg,3,1,,2,2,0,,4
4167,Udvisningsdømte,15,2,,1,15,2,,17
4168,handleplan,15,2,,1,15,2,,17
4169,AMU-kurser,15,2,,1,15,2,,17
4170,https://t.co/D2DiCSmnDi,15,2,,1,15,2,,17
4171,arbejdsro,120,7,,2,60,4,,127
4172,trods,96,28,,4,24,7,,124
4173,grundlag,449,34,,8,56,4,,483
4174,ovenikøbet,31,6,,1,31,6,,37
4175,https://t.co/UanU0XJnA0,31,6,,1,31,6,,37
4176,Hahah,39,1,,2,20,0,,40
4177,skuffe,49,11,,3,16,4,,60
4178,Argh,9,1,,2,4,0,,10
4179,much,4,0,,2,2,0,,4
4180,sandsynlighed,2,0,,1,2,0,,2
4181,Vare,2,0,,1,2,0,,2
4182,bande,4,3,,2,2,2,,7
4183,Christiania,31,8,,1,31,8,,39
4184,vedholdende,31,8,,1,31,8,,39
4185,Sundhedsministeriet,4,1,,2,2,0,,5
4186,Lønnen,2,0,,2,1,0,,2
4187,not,67,11,,2,34,6,,78
4188,iPhone,4,0,,1,4,0,,4
4189,Historier,6,3,,2,3,2,,9
4190,topvigtige,15,0,,1,15,0,,15
4191,tempobonus,34,2,,1,34,2,,36
4192,hjemmel,34,2,,1,34,2,,36
4193,vilje,211,7,,5,42,1,,218
4194,hverdag,2735,90,,9,304,10,,2825
4195,bryllup,5,0,,1,5,0,,5
4196,24.,5,0,,1,5,0,,5
4197,https://t.co/KtK0ogDLb3,1,0,,1,1,0,,1
4198,supersløjt,1,0,,1,1,0,,1
4199,sammenligne,1,0,,1,1,0,,1
4200,nazityskl,1,0,,1,1,0,,1
4201,Hviderusland,36,1,,1,36,1,,37
4202,pressekort,36,1,,1,36,1,,37
4203,opposition,629,44,,8,79,6,,673
4204,Lukashenko,36,1,,1,36,1,,37
4205,https://t.co/sw6wIMBbYq,36,1,,1,36,1,,37
4206,Fødegangene,8,4,,1,8,4,,12
4207,Afsæt,8,4,,1,8,4,,12
4208,udkast,13,2,,2,6,1,,15
4209,reklameslogan,8,0,,1,8,0,,8
4210,gokkejokke,8,0,,1,8,0,,8
4211,pule,8,0,,1,8,0,,8
4212,https://t.co/tuOdgDRUIk,8,0,,1,8,0,,8
4213,Østafrika,1,1,,1,1,1,,2
4214,græshoppe,1,1,,1,1,1,,2
4215,bibelsk,1,1,,1,1,1,,2
4216,plag,1,1,,1,1,1,,2
4217,sværm,1,1,,1,1,1,,2
4218,afrika,5,2,,2,2,1,,7
4219,https://t.co/iavv0Eeu45,1,1,,1,1,1,,2
4220,bandepakke,48,6,,2,24,3,,54
4221,drabsdom,46,5,,1,46,5,,51
4222,bandepakkens,46,5,,1,46,5,,51
4223,rocke,46,5,,1,46,5,,51
4224,bandepakken,46,5,,1,46,5,,51
4225,strafferamme,46,5,,1,46,5,,51
4226,rum,105,9,,4,26,2,,114
4227,Teksten,0,0,,1,0,0,,0
4228,selvfølge,2,0,,2,1,0,,2
4229,overensstemmelse,37,7,,3,12,2,,44
4230,konvention,430,65,,9,48,7,,495
4231,tyv,11,1,,1,11,1,,12
4232,kniv,23,9,,2,12,4,,32
4233,Samtlige,282,20,,2,141,10,,302
4234,mellemøst-eksperter,19,6,,1,19,6,,25
4235,Trumps,99,24,,4,25,6,,123
4236,Mellemøstpolitik,19,6,,1,19,6,,25
4237,roligt/,19,6,,1,19,6,,25
4238,velrenomerede,19,6,,1,19,6,,25
4239,amerikansk,225,29,,8,28,4,,254
4240,magasin,19,6,,1,19,6,,25
4241,Nobels,19,6,,1,19,6,,25
4242,Hvide,46,9,,2,23,4,,55
4243,Hus.#dkpol,19,6,,1,19,6,,25
4244,Ideen,84,9,,2,42,4,,93
4245,dæmpe,1,1,,1,1,1,,2
4246,urolighed,1,1,,1,1,1,,2
4247,pålidelig,311,53,,2,156,26,,364
4248,effektiv,73,22,,6,12,4,,95
4249,produktiv,56,15,,2,28,8,,71
4250,sundhedscafe,4,1,,1,4,1,,5
4251,19/11,4,1,,1,4,1,,5
4252,https://t.co/LXaojsvwYZ,4,1,,1,4,1,,5
4253,overbetaling,44,5,,1,44,5,,49
4254,griskhed,44,5,,1,44,5,,49
4255,pengepugning,44,5,,1,44,5,,49
4256,Udligning,45,3,,2,22,2,,48
4257,skuldre,7,2,,2,4,1,,9
4258,frederiksberg,5,1,,1,5,1,,6
4259,gentofte,5,1,,1,5,1,,6
4260,https://t.co/SHP2HnluSP,5,1,,1,5,1,,6
4261,Fleksibilitet,1,0,,1,1,0,,1
4262,blog,23,20,,2,12,10,,43
4263,http://t.co/gNDl80scrA,15,18,,1,15,18,,33
4264,Vigtige,18,5,,2,9,2,,23
4265,pointer,23,8,,3,8,3,,31
4266,Oldtidskundskab,2,1,,1,2,1,,3
4267,danne,2,1,,1,2,1,,3
4268,Rygning,18,1,,1,18,1,,19
4269,mørke,85,6,,2,42,3,,91
4270,ros,10,2,,1,10,2,,12
4271,ordførertale,4,0,,1,4,0,,4
4272,https://t.co/MnBTAIQLah,4,0,,1,4,0,,4
4273,snak,352,61,,22,16,3,,413
4274,udenrigsminister,24,6,,3,8,2,,30
4275,Aleppo,27,12,,2,14,6,,39
4276,https://t.co/nXgZxfNY8U,4,4,,1,4,4,,8
4277,Kviklån,54,2,,1,54,2,,56
4278,ekstrem,161,26,,3,54,9,,187
4279,rente,108,4,,2,54,2,,112
4280,halv,498,14,,5,100,3,,512
4281,vaskemaskine,54,2,,1,54,2,,56
4282,gebyr,54,2,,1,54,2,,56
4283,ÅOP=39,54,2,,1,54,2,,56
4284,formynderisk,54,2,,1,54,2,,56
4285,forbrugslån,54,2,,1,54,2,,56
4286,Samme,24,9,,4,6,2,,33
4287,smule,14,2,,4,4,0,,16
4288,postulere,2,0,,1,2,0,,2
4289,uretfærdig,4,0,,2,2,0,,4
4290,kvindelig,2,0,,1,2,0,,2
4291,spiller,3,1,,3,1,0,,4
4292,mandlig,102,10,,3,34,3,,112
4293,praktisere,45,12,,1,45,12,,57
4294,https://t.co/KEqx1slerf,45,12,,1,45,12,,57
4295,Patrick,5,0,,1,5,0,,5
4296,finte,104,15,,8,13,2,,119
4297,hysterisk,196,15,,4,49,4,,211
4298,venstrefløjskrigere,1,0,,1,1,0,,1
4299,heks,0,0,,1,0,0,,0
4300,omfatte,3,0,,2,2,0,,3
4301,statistisk,2,0,,1,2,0,,2
4302,materiale,2,0,,1,2,0,,2
4303,uhomogen,2,0,,1,2,0,,2
4304,oftere,718,55,,4,180,14,,773
4305,konflikt,110,16,,6,18,3,,126
4306,homogen,2,0,,1,2,0,,2
4307,Samlet,3,0,,1,3,0,,3
4308,psykiatri,600,112,,17,35,7,,712
4309,fælleskab,154,22,,2,77,11,,176
4310,https://t.co/wlkO69KizS,3,0,,1,3,0,,3
4311,EUs,63,20,,5,13,4,,83
4312,fødevarerpriser,0,0,,1,0,0,,0
4313,landbrugsland,0,0,,1,0,0,,0
4314,moms,24,5,,2,12,2,,29
4315,tv2valg,100,72,,14,7,5,,172
4316,tema-debat,1,1,,1,1,1,,2
4317,coronakrisen,577,54,,3,192,18,,631
4318,udviklingsstrategi,1,1,,1,1,1,,2
4319,https://t.co/UcerVBggFE,1,1,,1,1,1,,2
4320,bold,3,2,,1,3,2,,5
4321,ASAP,3,2,,1,3,2,,5
4322,https://t.co/AbY57SSn4o,3,2,,1,3,2,,5
4323,flygtningelandsbyer,8,5,,1,8,5,,13
4324,automatisk,8,5,,1,8,5,,13
4325,veu,14,0,,1,14,0,,14
4326,efteruddanne,14,0,,1,14,0,,14
4327,arbejdsstyrke,14,0,,1,14,0,,14
4328,https://t.co/ZocbPPRUbC,14,0,,1,14,0,,14
4329,sammenhold,29,3,,3,10,1,,32
4330,formå,13,1,,1,13,1,,14
4331,busk,13,1,,1,13,1,,14
4332,statsrevisor,214,2,,1,214,2,,216
4333,barsel,218,4,,5,44,1,,222
4334,elcykel,2,0,,1,2,0,,2
4335,cyklistforbund,2,0,,1,2,0,,2
4336,klimastrejke,273,9,,2,136,4,,282
4337,GrøntValg,2,0,,1,2,0,,2
4338,selve,87,16,,5,17,3,,103
4339,værdisættelse,6,0,,1,6,0,,6
4340,Gladsaxe,2,0,,1,2,0,,2
4341,lude,6,0,,1,6,0,,6
4342,bygning,6,0,,1,6,0,,6
4343,upassende,6,0,,1,6,0,,6
4344,trafikere,88,11,,1,88,11,,99
4345,H.C.,88,11,,1,88,11,,99
4346,Andersens,88,11,,1,88,11,,99
4347,Boulevard,88,11,,1,88,11,,99
4348,https://t.co/Y3GdnQ9vNP,88,11,,1,88,11,,99
4349,ihærdig,2,0,,1,2,0,,2
4350,partileder,1106,38,,2,553,19,,1144
4351,gavn,603,41,,11,55,4,,644
4352,Kristi,215,10,,1,215,10,,225
4353,Himmelfarts,215,10,,1,215,10,,225
4354,oplevelsestilbud,215,10,,1,215,10,,225
4355,sjover,215,10,,1,215,10,,225
4356,Amerikanere,1,0,,1,1,0,,1
4357,kineser,1,0,,1,1,0,,1
4358,Grænsen,1,0,,2,0,0,,1
4359,droppe,70,3,,2,35,2,,73
4360,Lene,33,2,,2,16,1,,35
4361,Espersen,200,20,,3,67,7,,220
4362,https://t.co/RqMCK10g1I,37,4,,1,37,4,,41
4363,Benjamin,2,0,,2,1,0,,2
4364,tjeneste,8,1,,3,3,0,,9
4365,bus,36,5,,5,7,1,,41
4366,cykel,34,0,,3,11,0,,34
4367,valgplakat,18,3,,3,6,1,,21
4368,besøgstal,35,4,,1,35,4,,39
4369,Prisen,35,4,,1,35,4,,39
4370,ring,802,82,,11,73,7,,884
4371,sommervejr,35,4,,1,35,4,,39
4372,kulturpartnerskaber,35,4,,1,35,4,,39
4373,målgruppe,37,5,,2,18,2,,42
4374,kendskab,35,4,,1,35,4,,39
4375,https://t.co/6mzQS0hnPw,35,4,,1,35,4,,39
4376,Roskilde,12,1,,2,6,0,,13
4377,Helsingør,1,0,,2,0,0,,1
4378,HIllerød,1,0,,1,1,0,,1
4379,Malmø,1,0,,1,1,0,,1
4380,dagsudflugter,1,0,,1,1,0,,1
4381,verdensklasseattraktioner,1,0,,1,1,0,,1
4382,Uddrag,310,34,,2,155,17,,344
4383,hastebehandlinger,308,30,,1,308,30,,338
4384,bolig,241,32,,8,30,4,,273
4385,bilag,5,1,,2,2,0,,6
4386,utaknemmelighed,175,10,,1,175,10,,185
4387,statue,175,10,,1,175,10,,185
4388,https://t.co/hwB5rGylhL,175,10,,1,175,10,,185
4389,fiasko,72,4,,1,72,4,,76
4390,blege,72,4,,1,72,4,,76
4391,magsinetliv,72,4,,1,72,4,,76
4392,https://t.co/ftMerZism9,72,4,,1,72,4,,76
4393,Feminister,162,8,,1,162,8,,170
4394,trædesten,162,8,,1,162,8,,170
4395,Brunsviger,5,1,,1,5,1,,6
4396,regnskab,8,2,,2,4,1,,10
4397,smittetryk,0,0,,1,0,0,,0
4398,Eksperter,9,2,,1,9,2,,11
4399,klimaløsninger,80,4,,3,27,1,,84
4400,bugt,9,2,,1,9,2,,11
4401,køleskab,9,2,,1,9,2,,11
4402,vindmølle,27,8,,3,9,3,,35
4403,madspild,9,2,,1,9,2,,11
4404,Løsninger,9,2,,1,9,2,,11
4405,El-biler,9,2,,1,9,2,,11
4406,bilpark,9,2,,1,9,2,,11
4407,udligne,9,2,,1,9,2,,11
4408,gevinst,30,5,,4,8,1,,35
4409,http://t.co/DXsUeasCa3,1,1,,1,1,1,,2
4410,butikstyveri,1,1,,1,1,1,,2
4411,klimavenligt,2,1,,1,2,1,,3
4412,halm,2,1,,1,2,1,,3
4413,flybrændstof,2,1,,1,2,1,,3
4414,kulstoflagring,2,1,,1,2,1,,3
4415,Landbrugets,265,32,,2,132,16,,297
4416,interesseorganisation,21,2,,2,10,1,,23
4417,tv-reklame,2,0,,1,2,0,,2
4418,annoncering,2,0,,1,2,0,,2
4419,indrykning,2,0,,1,2,0,,2
4420,mellemtid,2,0,,1,2,0,,2
4421,muntre,2,0,,1,2,0,,2
4422,låneudbydere,2,0,,1,2,0,,2
4423,SUK,2,0,,1,2,0,,2
4424,https://t.co/GiW8MDcYgY,77,18,,1,77,18,,95
4425,Folkeskolen,6,3,,1,6,3,,9
4426,klr15,6,3,,1,6,3,,9
4427,skyldig,0,0,,2,0,0,,0
4428,pakke,79,12,,5,16,2,,91
4429,Åbenbart,0,0,,1,0,0,,0
4430,specifik,1,1,,2,0,0,,2
4431,februar,22,4,,3,7,1,,26
4432,vending,2,1,,2,1,0,,3
4433,supplement,1,0,,1,1,0,,1
4434,Godmorgen,177,37,,2,88,18,,214
4435,bananskræld,6,5,,1,6,5,,11
4436,humor,239,15,,3,80,5,,254
4437,islamismens,6,5,,1,6,5,,11
4438,brutal,6,5,,1,6,5,,11
4439,gift,49,9,,2,24,4,,58
4440,fars,22,6,,1,22,6,,28
4441,morse,22,6,,1,22,6,,28
4442,arveafgift,22,6,,1,22,6,,28
4443,skattekiste,22,6,,1,22,6,,28
4444,https://t.co/aUoauzvJPK,22,6,,1,22,6,,28
4445,krænkelse,107,19,,6,18,3,,126
4446,FN-ambassadør,0,0,,1,0,0,,0
4447,FN's,12,6,,2,6,3,,18
4448,22skammelsen,2,0,,1,2,0,,2
4449,indfødsretsprøven,2,0,,1,2,0,,2
4450,klimavenlig,75,11,,2,38,6,,86
4451,Skab,3,1,,1,3,1,,4
4452,investeringsincitament,3,1,,1,3,1,,4
4453,https://t.co/85ZP817Y2u,3,1,,1,3,1,,4
4454,grønpåborgen,3,1,,1,3,1,,4
4455,stiller,6,2,,2,3,1,,8
4456,Jylland,34,8,,2,17,4,,42
4457,Motorvejscafeteriet,26,3,,1,26,3,,29
4458,Lillebælt,26,3,,1,26,3,,29
4459,https://t.co/nIHcAcO6yu,26,3,,1,26,3,,29
4460,omvende,94,19,,5,19,4,,113
4461,hvidt,0,0,,1,0,0,,0
4462,Maria,135,1,,2,68,0,,136
4463,https://t.co/rIYSXRAY7d,134,1,,1,134,1,,135
4464,skoledag,113,24,,9,13,3,,137
4465,dr2dagen,14,4,,2,7,2,,18
4466,demens,52,11,,2,26,6,,63
4467,GPS,50,10,,1,50,10,,60
4468,tryghed,487,78,,17,29,5,,565
4469,sygdomsramt,50,10,,1,50,10,,60
4470,Politikersvar,0,0,,1,0,0,,0
4471,bønne,24,9,,2,12,4,,33
4472,minut,278,53,,11,25,5,,331
4473,Følg,256,27,,5,51,5,,283
4474,kommentér,59,8,,1,59,8,,67
4475,https://t.co/5GjpHjyNob,59,8,,1,59,8,,67
4476,Njaaaa,4,0,,1,4,0,,4
4477,udtrykke,4,0,,1,4,0,,4
4478,risengrød,8,0,,1,8,0,,8
4479,topmøde,48,19,,2,24,10,,67
4480,Achim,7,0,,1,7,0,,7
4481,Steiner,7,0,,1,7,0,,7
4482,FNs,96,11,,4,24,3,,107
4483,udviklingsprogram,7,0,,1,7,0,,7
4484,stasministeren,7,0,,1,7,0,,7
4485,klimauge,7,0,,1,7,0,,7
4486,New,194,34,,6,32,6,,228
4487,York,42,11,,3,14,4,,53
4488,ClimateChange,7,0,,1,7,0,,7
4489,UNGA74,7,0,,1,7,0,,7
4490,reklamere,7,0,,3,2,0,,7
4491,Skolevold,3,0,,1,3,0,,3
4492,Skolelærere,3,0,,1,3,0,,3
4493,https://t.co/Dc5qsbtXI7,3,0,,1,3,0,,3
4494,https://t.co/po24co8OdF,3,0,,1,3,0,,3
4495,Europols,8,1,,1,8,1,,9
4496,register,8,1,,1,8,1,,9
4497,smartphone,8,1,,1,8,1,,9
4498,salafistisk-pakke,9,3,,1,9,3,,12
4499,jøde-had,9,3,,1,9,3,,12
4500,Lea,6,0,,1,6,0,,6
4501,Ca.,0,0,,1,0,0,,0
4502,Omegn,29,11,,2,14,6,,40
4503,vildsvin,11,0,,3,4,0,,11
4504,https://t.co/1F8QLapWrm,1,1,,1,1,1,,2
4505,fjolle,15,1,,1,15,1,,16
4506,selvportræt,30,2,,2,15,1,,32
4507,beslutsom,15,1,,1,15,1,,16
4508,uendelig,5,0,,3,2,0,,5
4509,skov,39,11,,8,5,1,,50
4510,håndtering,141,19,,6,24,3,,160
4511,fremtoning,4,0,,1,4,0,,4
4512,journalistik,89,7,,3,30,2,,96
4513,coronahåndtering,4,0,,1,4,0,,4
4514,https://t.co/Z5rPOkRX50,35,1,,1,35,1,,36
4515,Eftersom,0,0,,1,0,0,,0
4516,spøgefugl,0,0,,1,0,0,,0
4517,hovedprioritet,13,10,,1,13,10,,23
4518,skatteforhandlinger,13,10,,1,13,10,,23
4519,https://t.co/9FgTfWojwK,13,10,,1,13,10,,23
4520,Følelsen,1,0,,1,1,0,,1
4521,give,90,47,,2,45,24,,137
4522,praj,90,47,,1,90,47,,137
4523,Nja,8,0,,1,8,0,,8
4524,https://t.co/BMipPFj9fo,6,3,,1,6,3,,9
4525,show,5,0,,1,5,0,,5
4526,brændevin,1,0,,1,1,0,,1
4527,Snapsen,0,0,,1,0,0,,0
4528,imponere,64,1,,2,32,0,,65
4529,parlamentarisme,63,1,,1,63,1,,64
4530,Mht.,1,0,,1,1,0,,1
4531,Spændene,0,0,,1,0,0,,0
4532,VKR,0,0,,1,0,0,,0
4533,statsunderskud,19,0,,1,19,0,,19
4534,Netværket,3,0,,1,3,0,,3
4535,https://t.co/jzdVjTKtNe,3,0,,1,3,0,,3
4536,sagsbehandling,39,6,,3,13,2,,45
4537,Forretningspotentialet,1,0,,1,1,0,,1
4538,tilstandsrapport,1,0,,1,1,0,,1
4539,forhandler,54,4,,2,27,2,,58
4540,ødelægge,8,6,,2,4,3,,14
4541,Stor,370,35,,5,74,7,,405
4542,årlig,44,2,,1,44,2,,46
4543,fanseminar,44,2,,1,44,2,,46
4544,tryg,168,23,,5,34,5,,191
4545,stadionoplevelse,44,2,,1,44,2,,46
4546,klub,46,2,,3,15,1,,48
4547,pyroteknik,44,2,,1,44,2,,46
4548,farve,90,6,,2,45,3,,96
4549,ægtefans,44,2,,1,44,2,,46
4550,https://t.co/dOUfDW3NJA,44,2,,1,44,2,,46
4551,produktion,101,13,,8,13,2,,114
4552,Klima,10,3,,2,5,2,,13
4553,https://t.co/VYoMDN9Ejh,0,0,,1,0,0,,0
4554,7-årige,6,0,,1,6,0,,6
4555,trætte,84,9,,5,17,2,,93
4556,folkestorm,6,0,,1,6,0,,6
4557,episode,9,0,,3,3,0,,9
4558,Frost-koncerter,6,0,,1,6,0,,6
4559,blegne,6,0,,1,6,0,,6
4560,Halloweendrama,6,0,,1,6,0,,6
4561,interval,3,0,,1,3,0,,3
4562,citationstegn,3,0,,1,3,0,,3
4563,bollegyngerne,22,3,,1,22,3,,25
4564,karrusel,22,3,,1,22,3,,25
4565,tredje,9,1,,5,2,0,,10
4566,periode,443,50,,6,74,8,,493
4567,stemmetal,0,0,,1,0,0,,0
4568,Kriminelle,58,6,,2,29,3,,64
4569,familielæge,10,3,,1,10,3,,13
4570,udeblive,10,3,,1,10,3,,13
4571,utryg,10,3,,1,10,3,,13
4572,mail,124,17,,6,21,3,,141
4573,E-boks,10,3,,1,10,3,,13
4574,https://t.co/WrphOYUIqR,10,3,,1,10,3,,13
4575,Nicolai,1,0,,2,0,0,,1
4576,uro,0,0,,1,0,0,,0
4577,varsle,0,0,,1,0,0,,0
4578,Tjekke,1,0,,1,1,0,,1
4579,papir,35,5,,4,9,1,,40
4580,båd,137,6,,3,46,2,,143
4581,samvær,131,6,,2,66,3,,137
4582,Slagene,131,6,,1,131,6,,137
4583,erhvervsdrivende,131,6,,1,131,6,,137
4584,krise,644,69,,8,80,9,,713
4585,Forestiller,6,0,,1,6,0,,6
4586,statsborgerskabsceremonien,6,0,,1,6,0,,6
4587,citat,156,14,,9,17,2,,170
4588,Slagtersønnen,0,0,,1,0,0,,0
4589,Sammy,0,0,,1,0,0,,0
4590,Lee,0,0,,1,0,0,,0
4591,facebook,23,0,,4,6,0,,23
4592,racistisk,47,4,,2,24,2,,51
4593,racist,745,47,,5,149,9,,792
4594,nisse,3,0,,1,3,0,,3
4595,dårligdom,190,25,,3,63,8,,215
4596,Negativ,18,1,,1,18,1,,19
4597,Covid-19,36,2,,2,18,1,,38
4598,svartid,18,1,,1,18,1,,19
4599,QuickTestCenter,18,1,,1,18,1,,19
4600,Føj,43,7,,2,22,4,,50
4601,pind,18,1,,1,18,1,,19
4602,næse,75,11,,5,15,2,,86
4603,ubehagelig,67,1,,4,17,0,,68
4604,https://t.co/8Jn131TtKZ,18,1,,1,18,1,,19
4605,Fan,7,0,,1,7,0,,7
4606,business,119,34,,3,40,11,,153
4607,kombi,25,7,,2,12,4,,32
4608,Skønt,7,0,,1,7,0,,7
4609,Lokkede,7,0,,1,7,0,,7
4610,Hildebrandt,7,0,,1,7,0,,7
4611,Makeen,7,0,,1,7,0,,7
4612,Energy,38,17,,2,19,8,,55
4613,energieffektiviseringsudspil,157,14,,1,157,14,,171
4614,https://t.co/gpn8cZuT9D,157,14,,1,157,14,,171
4615,nazist,1,0,,1,1,0,,1
4616,klimavalg,12,7,,1,12,7,,19
4617,kke,12,7,,1,12,7,,19
4618,fodslæbende,12,7,,1,12,7,,19
4619,https://t.co/1z0yYHShzv,12,7,,1,12,7,,19
4620,sosu,6,1,,1,6,1,,7
4621,håndværksfag,6,1,,1,6,1,,7
4622,eud,6,1,,1,6,1,,7
4623,http://t.co/ZW1HSb3cof,6,1,,1,6,1,,7
4624,overgå,1,2,,1,1,2,,3
4625,nødpasning,1,2,,1,1,2,,3
4626,dagtilbud,13,6,,3,4,2,,19
4627,https://t.co/76dQNAmqqC,1,2,,1,1,2,,3
4628,hensyn,350,57,,11,32,5,,407
4629,Klimaforandringerne,92,14,,1,92,14,,106
4630,Norge,288,63,,7,41,9,,351
4631,Finland,269,45,,3,90,15,,314
4632,https://t.co/BOBAO24eDh,92,14,,1,92,14,,106
4633,udstrække,2,1,,1,2,1,,3
4634,råderum,267,28,,8,33,4,,295
4635,retning,685,80,,15,46,5,,765
4636,udstille,23,5,,2,12,2,,28
4637,FL21,187,32,,6,31,5,,219
4638,ftlive#dkpol,2,1,,1,2,1,,3
4639,Soloselvstændige,63,7,,1,63,7,,70
4640,firma,67,11,,3,22,4,,78
4641,straksindmeldelser,63,7,,1,63,7,,70
4642,a-kasse,63,7,,1,63,7,,70
4643,.@Enhedslisten,30,8,,1,30,8,,38
4644,B113,30,8,,1,30,8,,38
4645,sommerferie,30,8,,1,30,8,,38
4646,husdyrproduktion,30,8,,1,30,8,,38
4647,https://t.co/cy2bEWbXZ2,30,8,,1,30,8,,38
4648,https://t.co/TMkR0iBHf7,30,8,,1,30,8,,38
4649,fugl,50,12,,1,50,12,,62
4650,https://t.co/kBGTBeym59,50,12,,1,50,12,,62
4651,Hov,71,13,,4,18,3,,84
4652,nedslidtes,31,9,,1,31,9,,40
4653,pensionsalder,221,50,,11,20,5,,271
4654,Tulle,31,9,,1,31,9,,40
4655,https://t.co/H4ObzR0B6v,31,9,,1,31,9,,40
4656,nedskæring,447,83,,11,41,8,,530
4657,arbejdsmiljø,6,3,,2,3,2,,9
4658,http://t.co/kUzAYqAZoy,3,3,,1,3,3,,6
4659,milliardskatterabat,2,0,,1,2,0,,2
4660,YEMEN,1,1,,1,1,1,,2
4661,Saudi,1,1,,1,1,1,,2
4662,Iran,287,72,,4,72,18,,359
4663,Yemen,1,1,,1,1,1,,2
4664,lejer,236,20,,1,236,20,,256
4665,kapitalfondenes,236,20,,1,236,20,,256
4666,rovdrift,236,20,,1,236,20,,256
4667,karensperiode,236,20,,1,236,20,,256
4668,https://t.co/lwZygJUuWi,236,20,,1,236,20,,256
4669,føp-flex,3,1,,1,3,1,,4
4670,proces,68,1,,4,17,0,,69
4671,enorm,47,5,,4,12,1,,52
4672,savn,4,1,,2,2,0,,5
4673,ledelse,115,24,,8,14,3,,139
4674,klimatruslen,3,0,,1,3,0,,3
4675,fireårig,24,8,,2,12,4,,32
4676,finanslovsaftale,12,4,,1,12,4,,16
4677,skatteforvaltning,86,9,,3,29,3,,95
4678,stabil,32,8,,2,16,4,,40
4679,bevilling,82,17,,6,14,3,,99
4680,midlertidig,38,7,,5,8,1,,45
4681,Riskær-partiet,2,0,,1,2,0,,2
4682,UV-minister,2,0,,1,2,0,,2
4683,karakterkrav,2,0,,1,2,0,,2
4684,https://t.co/SKff6Dhf1Q,2,0,,1,2,0,,2
4685,Pesticider,3,1,,1,3,1,,4
4686,https://t.co/zKzFFpXCL8,3,1,,1,3,1,,4
4687,robust,39,3,,2,20,2,,42
4688,arbejdsskadeager,10,3,,1,10,3,,13
4689,https://t.co/muFzzxQgKY,10,3,,1,10,3,,13
4690,hed,3,1,,1,3,1,,4
4691,gigantskatterabatter,3,1,,1,3,1,,4
4692,justering,10,1,,2,5,0,,11
4693,skatterabat,73,9,,3,24,3,,82
4694,https://t.co/KfMB4WYYnf,3,1,,1,3,1,,4
4695,Enhedslistens,527,63,,5,105,13,,590
4696,bestyrelsesmedlem,27,5,,1,27,5,,32
4697,KL's,27,5,,1,27,5,,32
4698,https://t.co/cWjSDgCSM6,27,5,,1,27,5,,32
4699,landbrugsjord,1,0,,1,1,0,,1
4700,jordbrugerfond,1,0,,1,1,0,,1
4701,Livø,15,4,,2,8,2,,19
4702,Hald,1,0,,1,1,0,,1
4703,Kalø,1,0,,1,1,0,,1
4704,Libeeral,1,0,,1,1,0,,1
4705,Alliances,2,0,,2,1,0,,2
4706,kurs,213,16,,8,27,2,,229
4707,SU-modtagere,2,0,,1,2,0,,2
4708,Modtagere,2,0,,1,2,0,,2
4709,barselsdagpenge,2,0,,1,2,0,,2
4710,lock,204,19,,1,204,19,,223
4711,minoritetsbaggrund,204,19,,1,204,19,,223
4712,ansvarsforflygtigelse,208,21,,2,104,10,,229
4713,fradrag,2,0,,3,1,0,,2
4714,Varmeste,21,2,,1,21,2,,23
4715,våd,21,2,,1,21,2,,23
4716,Dan,132,31,,7,19,4,,163
4717,https://t.co/WgQALeVqPq,21,2,,1,21,2,,23
4718,IMRs,1,0,,1,1,0,,1
4719,Forbyd,2,0,,2,1,0,,2
4720,diskrimination,329,37,,6,55,6,,366
4721,handicapdk,1,0,,1,1,0,,1
4722,https://t.co/AYZIkiWcrq,1,0,,1,1,0,,1
4723,TTIP,2,1,,1,2,1,,3
4724,miljøregel,2,1,,1,2,1,,3
4725,arbejdstagerrettighed,2,1,,1,2,1,,3
4726,forbrugerbeskyttelse,2,1,,1,2,1,,3
4727,.@regeringen,10,4,,1,10,4,,14
4728,HK'er,10,4,,1,10,4,,14
4729,rådighedsbeløb,10,4,,1,10,4,,14
4730,direktør,16,5,,2,8,2,,21
4731,Lamborghinireform,10,4,,1,10,4,,14
4732,https://t.co/rvxfJ13nwY,10,4,,1,10,4,,14
4733,lomme,13,4,,1,13,4,,17
4734,EUD,54,23,,3,18,8,,77
4735,AUB,13,4,,1,13,4,,17
4736,praktikpladskatastrofe,13,4,,1,13,4,,17
4737,kapitalflugt,0,0,,1,0,0,,0
4738,http://t.co/xgvjdFxr01,0,0,,1,0,0,,0
4739,Indsats,201,14,,1,201,14,,215
4740,sexkrænkelser,201,14,,1,201,14,,215
4741,hadforbrydelser,342,28,,3,114,9,,370
4742,politiklagemyndighed,201,14,,1,201,14,,215
4743,team,205,15,,2,102,8,,220
4744,partnervold,257,27,,3,86,9,,284
4745,Stærkt,387,55,,8,48,7,,442
4746,Afskaffelse,40,18,,2,20,9,,58
4747,udligningsskatten,40,18,,1,40,18,,58
4748,klokkeklar,125,30,,2,62,15,,155
4749,topskattenedsættelse,40,18,,1,40,18,,58
4750,bagdør,108,33,,2,54,16,,141
4751,fordør,53,24,,2,26,12,,77
4752,LO-forbundenes,8,4,,1,8,4,,12
4753,efterslæb,8,4,,1,8,4,,12
4754,minere,8,4,,1,8,4,,12
4755,tildligere,8,4,,1,8,4,,12
4756,passivitet,27,5,,2,14,2,,32
4757,Fund,8,4,,1,8,4,,12
4758,knald,8,4,,1,8,4,,12
4759,sikkerhedsnet,160,25,,4,40,6,,185
4760,hovedrengøring,30,2,,1,30,2,,32
4761,https://t.co/xPTau12ImF,30,2,,1,30,2,,32
4762,minimumsnormeringer,742,78,,10,74,8,,820
4763,klimatiltag,68,15,,1,68,15,,83
4764,kvoteflygtning,80,21,,2,40,10,,101
4765,tonedøv,2,4,,1,2,4,,6
4766,alvoren,2,4,,1,2,4,,6
4767,https://t.co/NbpxOR7FXA,2,4,,1,2,4,,6
4768,ærgerlig,6,0,,3,2,0,,6
4769,huslejestigning,5,0,,1,5,0,,5
4770,Pointen,127,15,,3,42,5,,142
4771,kickstartet,0,0,,1,0,0,,0
4772,efterspørgsel,24,5,,2,12,2,,29
4773,Spørgsmålet,18,4,,3,6,1,,22
4774,Tåregas,21,2,,1,21,2,,23
4775,gummikugle,21,2,,1,21,2,,23
4776,migranter,197,46,,5,39,9,,243
4777,forfølgelse,37,3,,3,12,1,,40
4778,Udenrigsministeren,29,4,,2,14,2,,33
4779,officiel,367,35,,8,46,4,,402
4780,Gang,14,7,,1,14,7,,21
4781,Løbere,14,7,,1,14,7,,21
4782,Gaza,14,7,,1,14,7,,21
4783,eet,2,1,,1,2,1,,3
4784,autoritær,247,23,,4,62,6,,270
4785,Ortega-regeringen,2,1,,1,2,1,,3
4786,Nicaragua,2,2,,2,1,1,,4
4787,udenrigspolitik,12,3,,2,6,2,,15
4788,https://t.co/PrgZYS67BQ,2,1,,1,2,1,,3
4789,SKAT,40,19,,4,10,5,,59
4790,https://t.co/LmHJ6o6BJd,30,14,,1,30,14,,44
4791,kurder,5,2,,1,5,2,,7
4792,IS-forbrydere,5,2,,1,5,2,,7
4793,dødelig,5,2,,1,5,2,,7
4794,IS-forbryderne,5,2,,1,5,2,,7
4795,https://t.co/fn3XPzI9X7,5,2,,1,5,2,,7
4796,Corydons,1,1,,1,1,1,,2
4797,Thornings,1,1,,1,1,1,,2
4798,svigt,138,34,,5,28,7,,172
4799,https://t.co/DfSoPQpaIl,1,1,,1,1,1,,2
4800,Banken,1,0,,1,1,0,,1
4801,polstring,1,0,,1,1,0,,1
4802,aktionær,1,0,,1,1,0,,1
4803,Pengene,22,1,,2,11,0,,23
4804,https://t.co/4JZZ6urZ4i,1,0,,1,1,0,,1
4805,aktstykke,0,0,,1,0,0,,0
4806,Finansudvalget,0,0,,1,0,0,,0
4807,mediestøtten,0,0,,1,0,0,,0
4808,ikke-statslig,0,0,,1,0,0,,0
4809,ukritisk,7,1,,2,4,0,,8
4810,Barfod,3,3,,1,3,3,,6
4811,Arbejdsgiverne,3,3,,1,3,3,,6
4812,pung,3,3,,1,3,3,,6
4813,Fodslag,3,1,,1,3,1,,4
4814,dumping,121,26,,5,24,5,,147
4815,ID-kort,3,1,,1,3,1,,4
4816,byggeplads,52,8,,2,26,4,,60
4817,skrap,3,1,,2,2,0,,4
4818,transportbranchen,3,1,,1,3,1,,4
4819,markant,52,8,,8,6,1,,60
4820,kompetent,93,15,,4,23,4,,108
4821,Strategisk,0,0,,1,0,0,,0
4822,kakao,25,2,,2,12,1,,27
4823,kakaomælk,25,2,,1,25,2,,27
4824,kakaodrik,25,2,,1,25,2,,27
4825,https://t.co/HRG5KRj2qc,25,2,,1,25,2,,27
4826,satspuljeaftale,128,20,,1,128,20,,148
4827,folkepensionist,128,20,,1,128,20,,148
4828,ukrudtsdrik,16,1,,1,16,1,,17
4829,dælens,16,1,,1,16,1,,17
4830,skvalderkål,16,1,,1,16,1,,17
4831,https://t.co/sc0lK39WEk,16,1,,1,16,1,,17
4832,hudfarve,60,9,,2,30,4,,69
4833,kleptomaner,2,1,,1,2,1,,3
4834,jakkesæt,2,1,,1,2,1,,3
4835,Beboernes,2,1,,1,2,1,,3
4836,sparepenge,2,1,,1,2,1,,3
4837,https://t.co/IY8puiLwm7,2,1,,1,2,1,,3
4838,afkorte,7,5,,1,7,5,,12
4839,Loven,36,7,,2,18,4,,43
4840,afkortning,7,5,,1,7,5,,12
4841,https://t.co/rlIt16l2L0,7,5,,1,7,5,,12
4842,grundskoletilbud,2,1,,1,2,1,,3
4843,VLAK,77,27,,6,13,4,,104
4844,https://t.co/fspXczgrra,70,23,,1,70,23,,93
4845,smitteopspore,4,0,,1,4,0,,4
4846,opsøgning,4,0,,1,4,0,,4
4847,fregat,6,1,,2,3,0,,7
4848,merværdi,3,1,,1,3,1,,4
4849,øvelse,3,1,,1,3,1,,4
4850,alenetid,69,16,,1,69,16,,85
4851,forældrebetaling,69,16,,2,34,8,,85
4852,gruppestørrelser,69,16,,1,69,16,,85
4853,HvorErDerEnVoksen,69,16,,1,69,16,,85
4854,https://t.co/9IoTI5m9S3,69,16,,1,69,16,,85
4855,tom,73,31,,2,36,16,,104
4856,erhvervsuddannelse,316,57,,7,45,8,,373
4857,https://t.co/XUNU2WlXuF,58,28,,1,58,28,,86
4858,Shit,31,3,,3,10,1,,34
4859,teamarbejde,26,3,,1,26,3,,29
4860,venstre-ministre,50,9,,1,50,9,,59
4861,trofæ,50,9,,1,50,9,,59
4862,Eva,95,17,,2,48,8,,112
4863,Kjær,50,9,,1,50,9,,59
4864,musling,50,9,,1,50,9,,59
4865,fisker,56,13,,2,28,6,,69
4866,Helt,4,0,,1,4,0,,4
4867,stalinistisk,4,0,,1,4,0,,4
4868,diktatur,123,14,,2,62,7,,137
4869,Socialisme,4,0,,1,4,0,,4
4870,frihedsrettighed,380,16,,2,190,8,,396
4871,kære,181,37,,4,45,9,,218
4872,kristlige,2,1,,1,2,1,,3
4873,dkaid,519,138,,17,31,8,,657
4874,3F-top,1,1,,1,1,1,,2
4875,omstridt,1,1,,1,1,1,,2
4876,positiv,197,20,,13,15,2,,217
4877,Soldater,5,2,,1,5,2,,7
4878,overvågning,1260,126,,4,315,32,,1386
4879,militarisering,33,15,,2,16,8,,48
4880,FØP-reformen,0,1,,1,0,1,,1
4881,https://t.co/sMEAhMBs0,0,1,,1,0,1,,1
4882,L-forslag,10,10,,1,10,10,,20
4883,ghetto-pakken,10,10,,1,10,10,,20
4884,begrænse,437,32,,4,109,8,,469
4885,daginst,10,10,,1,10,10,,20
4886,institutionslukninger,10,10,,1,10,10,,20
4887,https://t.co/b3OTb7oNFc,10,10,,1,10,10,,20
4888,Sovebriller,4,1,,1,4,1,,5
4889,ankomst,4,1,,1,4,1,,5
4890,fm16,4,1,,1,4,1,,5
4891,DONG,4,1,,1,4,1,,5
4892,https://t.co/SgGtrikcT5,4,1,,1,4,1,,5
4893,Modstand,1,1,,1,1,1,,2
4894,Alternativer,1,1,,1,1,1,,2
4895,ualmindelig,1,1,,1,1,1,,2
4896,Søndag,1,1,,1,1,1,,2
4897,https://t.co/YWEtbxtdP6,1,1,,1,1,1,,2
4898,søskende,46,6,,1,46,6,,52
4899,mordbrand,46,6,,1,46,6,,52
4900,Scandinavian,49,7,,2,24,4,,56
4901,Star,46,6,,1,46,6,,52
4902,uklarhed,46,6,,1,46,6,,52
4903,Corona-mutationerne,59,8,,1,59,8,,67
4904,folkesundhed,687,44,,4,172,11,,731
4905,https://t.co/dT9fenrN39,59,8,,1,59,8,,67
4906,rigsretssag,499,31,,3,166,10,,530
4907,Landets,11,3,,1,11,3,,14
4908,AMU,11,3,,1,11,3,,14
4909,coronanedlukningen,11,3,,1,11,3,,14
4910,https://t.co/zfuAwQ8Iqg,11,3,,1,11,3,,14
4911,sundhedsmyndighed,68,3,,6,11,0,,71
4912,selvstændig,403,48,,7,58,7,,451
4913,overgreb,314,25,,4,78,6,,339
4914,f**ing,39,1,,1,39,1,,40
4915,boss,45,1,,2,22,0,,46
4916,Tænksomme,0,1,,1,0,1,,1
4917,hovedløs,63,3,,1,63,3,,66
4918,markedsføring,93,6,,5,19,1,,99
4919,reklameloft,63,3,,1,63,3,,66
4920,central,114,10,,5,23,2,,124
4921,taxametersystem,63,3,,1,63,3,,66
4922,bøde,82,7,,6,14,1,,89
4923,katastrofal,110,25,,4,28,6,,135
4924,udslippe,50,5,,5,10,1,,55
4925,ton,180,26,,5,36,5,,206
4926,stof,140,33,,8,18,4,,173
4927,havmiljø,104,10,,5,21,2,,114
4928,udåd,36,3,,1,36,3,,39
4929,galt,3,0,,2,2,0,,3
4930,hals,156,18,,3,52,6,,174
4931,https://t.co/FOCKgcWKo7,5,6,,1,5,6,,11
4932,principprogram,6,0,,1,6,0,,6
4933,pædagogmedhjælper,109,1,,1,109,1,,110
4934,ekspertise,110,1,,2,55,0,,111
4935,daginsitutioner,109,1,,1,109,1,,110
4936,https://t.co/NW06db11Xo,12,2,,1,12,2,,14
4937,miljøbanditter,426,22,,1,426,22,,448
4938,multinassere,426,22,,1,426,22,,448
4939,hold,531,38,,10,53,4,,569
4940,retfærdig,550,35,,9,61,4,,585
4941,Pressemøde,6,2,,1,6,2,,8
4942,Island,183,33,,3,61,11,,216
4943,brydblokaden,6,2,,1,6,2,,8
4944,http://t.co/VTlr0xEBGC,6,2,,1,6,2,,8
4945,Pladsen,1,1,,1,1,1,,2
4946,trang,36,2,,2,18,1,,38
4947,daginstitution,245,43,,4,61,11,,288
4948,Børnegrupperne,1,1,,1,1,1,,2
4949,eupoldk,0,0,,1,0,0,,0
4950,PANDAERNE,32,5,,1,32,5,,37
4951,menneskerettighed,70,12,,5,14,2,,82
4952,https://t.co/QJEffl5oX6,32,5,,1,32,5,,37
4953,elite,191,41,,7,27,6,,232
4954,Fejl,0,0,,1,0,0,,0
4955,forelæsning,3,7,,1,3,7,,10
4956,forelæser,3,7,,1,3,7,,10
4957,stopbesparelsen,3,7,,1,3,7,,10
4958,https://t.co/AQp3cZx00D,0,1,,1,0,1,,1
4959,Tja,9,0,,3,3,0,,9
4960,bum,0,1,,3,0,0,,1
4961,polsk,0,0,,1,0,0,,0
4962,Polen,640,34,,5,128,7,,674
4963,helvede,561,53,,5,112,11,,614
4964,eskalere,112,18,,1,112,18,,130
4965,peberspray,144,23,,2,72,12,,167
4966,https://t.co/2EpPdZbzM6,112,18,,1,112,18,,130
4967,specialenhed,33,7,,1,33,7,,40
4968,virkelig,214,47,,3,71,16,,261
4969,tæt,246,54,,2,123,27,,300
4970,underklasse,291,56,,2,146,28,,347
4971,Dårligt,211,47,,1,211,47,,258
4972,https://t.co/p8M1SvKm4s,211,47,,1,211,47,,258
4973,Tusinde,1,0,,2,0,0,,1
4974,latinamerikansk,0,0,,1,0,0,,0
4975,Overflod,111,11,,1,111,11,,122
4976,https://t.co/isnRpSq06b,111,11,,1,111,11,,122
4977,Esben,33,9,,5,7,2,,42
4978,Lunde,27,9,,4,7,2,,36
4979,sød,20,2,,1,20,2,,22
4980,Karakterbonussen,26,0,,1,26,0,,26
4981,langsom,29,0,,3,10,0,,29
4982,P.s.,26,0,,1,26,0,,26
4983,forældrestøtte,26,0,,1,26,0,,26
4984,https://t.co/e6QemXLZ8Z,26,0,,1,26,0,,26
4985,hastelov,43,4,,1,43,4,,47
4986,håndsprit,43,4,,1,43,4,,47
4987,bagatelgrænse,43,4,,1,43,4,,47
4988,afsnit,43,4,,1,43,4,,47
4989,https://t.co/OZ4wx8uRdA,43,4,,1,43,4,,47
4990,rundvisning,26,0,,1,26,0,,26
4991,https://t.co/un5m1zlRAD,26,0,,1,26,0,,26
4992,Engelbrecht,1,2,,1,1,2,,3
4993,Pol,1,2,,1,1,2,,3
4994,DP-forlig,1,2,,1,1,2,,3
4995,lås,18,8,,2,9,4,,26
4996,corona-tider,3,0,,1,3,0,,3
4997,Ålborg,2,3,,1,2,3,,5
4998,https://t.co/WH04bLZrr4,2,3,,1,2,3,,5
4999,indflydelse,256,34,,12,21,3,,290
5000,fødevareforlig,5,2,,1,5,2,,7
5001,producent,6,2,,2,3,1,,8
5002,sprøjtegift,236,47,,5,47,9,,283
5003,https://t.co/EtBMonaJ3V,5,2,,1,5,2,,7
5004,socialisme,155,10,,6,26,2,,165
5005,Knæ,0,0,,1,0,0,,0
5006,nazi,0,0,,1,0,0,,0
5007,walk,1,0,,1,1,0,,1
5008,Hepper,44,6,,1,44,6,,50
5009,nysalg,44,6,,1,44,6,,50
5010,benzinbil,44,6,,1,44,6,,50
5011,reduktionsmetoder,44,6,,1,44,6,,50
5012,smertegrænse,1,2,,1,1,2,,3
5013,"folkeskole""?https://t.co",1,2,,1,1,2,,3
5014,nuWEPfHp5S,1,2,,1,1,2,,3
5015,Skatterabatten,2,1,,1,2,1,,3
5016,unødvendig,2,1,,1,2,1,,3
5017,Skatten,2,1,,1,2,1,,3
5018,Kasper,12,1,,2,6,0,,13
5019,Arbejdsgivernes,8,5,,1,8,5,,13
5020,misbrug,101,13,,3,34,4,,114
5021,praktikaftale,8,5,,1,8,5,,13
5022,https://t.co/ECREq6N0xs,8,5,,1,8,5,,13
5023,skolestart,18,6,,2,9,3,,24
5024,https://t.co/UMqVmSVeFm,9,3,,1,9,3,,12
5025,Besparelser,1,2,,1,1,2,,3
5026,produktionsvirksomhed,1,2,,1,1,2,,3
5027,Verdens,437,51,,3,146,17,,488
5028,udlede,308,34,,1,308,34,,342
5029,klimaregning,308,34,,1,308,34,,342
5030,overbefolkning,308,34,,1,308,34,,342
5031,Samira,15,7,,1,15,7,,22
5032,forberedelse,21,8,,3,7,3,,29
5033,undervisning,223,22,,6,37,4,,245
5034,https://t.co/G3zqB4FCml,15,7,,1,15,7,,22
5035,borgerrådgivere,7,1,,1,7,1,,8
5036,https://t.co/XndCkbDgvY,7,1,,1,7,1,,8
5037,boligskatteaftale,10,0,,1,10,0,,10
5038,Miljøøkonomiske,0,0,,1,0,0,,0
5039,Råd,1,1,,2,0,0,,2
5040,Venezuela,0,1,,2,0,0,,1
5041,status,93,21,,8,12,3,,114
5042,AIF,0,1,,1,0,1,,1
5043,Sindal,44,8,,1,44,8,,52
5044,slagteriarbejder,64,8,,2,32,4,,72
5045,Ringsted,44,8,,1,44,8,,52
5046,buschauffør,44,8,,1,44,8,,52
5047,COVID-19,85,13,,3,28,4,,98
5048,https://t.co/P2lDBBgmXG,44,8,,1,44,8,,52
5049,såkaldt,99,23,,5,20,5,,122
5050,kvotekonger,2,0,,1,2,0,,2
5051,https://t.co/Sj3moOvixE,2,0,,1,2,0,,2
5052,øde,3,2,,1,3,2,,5
5053,skør,86,9,,3,29,3,,95
5054,https://t.co/LU6RvaMIN9,3,2,,1,3,2,,5
5055,Fællessang,10,1,,1,10,1,,11
5056,synge,208,10,,2,104,5,,218
5057,plakat,37,3,,5,7,1,,40
5058,lokalafdeling,28,1,,2,14,0,,29
5059,hamp,4,3,,1,4,3,,7
5060,ministerkandidat,4,3,,1,4,3,,7
5061,Sosserne,4,3,,1,4,3,,7
5062,https://t.co/wJYoymGEka,4,3,,1,4,3,,7
5063,Samfundsgavnlig,63,6,,1,63,6,,69
5064,minkavl,126,12,,2,63,6,,138
5065,Kæmpefordel,63,6,,1,63,6,,69
5066,ammoniakforurening,63,6,,1,63,6,,69
5067,alarm,2,1,,1,2,1,,3
5068,https://t.co/lp9aYJaf9,2,1,,1,2,1,,3
5069,Fraværsstraffen,34,6,,1,34,6,,40
5070,undervisningsminister,34,6,,1,34,6,,40
5071,https://t.co/L0yO2jKKhc,34,6,,1,34,6,,40
5072,detailstyring,9,0,,2,4,0,,9
5073,Armslængde,2,0,,1,2,0,,2
5074,princip,282,22,,8,35,3,,304
5075,Kontanthjælpsloft,5,5,,1,5,5,,10
5076,millimeter,5,5,,1,5,5,,10
5077,arb.markedet,5,5,,1,5,5,,10
5078,Altingetsocial,5,5,,1,5,5,,10
5079,http://t.co/1rNmfnvXCg,5,5,,1,5,5,,10
5080,politikersprog,0,0,,1,0,0,,0
5081,kaffe,13,1,,6,2,0,,14
5082,nat,0,0,,1,0,0,,0
5083,mangel,351,41,,7,50,6,,392
5084,klimaudspil,258,22,,1,258,22,,280
5085,udledere,258,22,,1,258,22,,280
5086,barnebarn,408,51,,4,102,13,,459
5087,Puha,5,2,,1,5,2,,7
5088,hardcore,5,2,,1,5,2,,7
5089,nationalstats-romantik,5,2,,1,5,2,,7
5090,militær,79,14,,4,20,4,,93
5091,slagkraftig,5,2,,1,5,2,,7
5092,harmoni,5,2,,1,5,2,,7
5093,UNGA,30,17,,2,15,8,,47
5094,Vandværkers,8,3,,1,8,3,,11
5095,drikkevand,241,55,,4,60,14,,296
5096,non-profit,8,3,,1,8,3,,11
5097,https://t.co/4bNyMbkS1Q,8,3,,1,8,3,,11
5098,https://t.co/0Dqy1L6IwW,6,0,,1,6,0,,6
5099,Vestsahara,4,1,,1,4,1,,5
5100,sejr,771,57,,8,96,7,,828
5101,Sydafrika,4,1,,2,2,0,,5
5102,marokkansk,4,1,,1,4,1,,5
5103,mineral,4,1,,1,4,1,,5
5104,off.fagforbund,56,21,,1,56,21,,77
5105,S-SF-R,56,21,,1,56,21,,77
5106,https://t.co/fEFAXfwsum,56,21,,1,56,21,,77
5107,lide,4,3,,4,1,1,,7
5108,enkeltes,2,1,,2,1,0,,3
5109,Kongehuset,45,4,,2,22,2,,49
5110,https://t.co/o1lhLPfPVE,1,1,,1,1,1,,2
5111,velfærdssamfund,1009,121,,14,72,9,,1130
5112,https://t.co/skKuGUh2M2,82,14,,1,82,14,,96
5113,100dagemedenhedslisten,82,14,,1,82,14,,96
5114,konspirationsteorierne,0,0,,1,0,0,,0
5115,Johnson,0,0,,1,0,0,,0
5116,skriftlig,8,1,,2,4,0,,9
5117,medio,0,0,,1,0,0,,0
5118,optakt,17,1,,2,8,0,,18
5119,genvalg,0,0,,1,0,0,,0
5120,fagforbund,15,3,,1,15,3,,18
5121,asocial,88,23,,5,18,5,,111
5122,FØP-,15,3,,1,15,3,,18
5123,Flexreform,15,3,,1,15,3,,18
5124,https://t.co/nB61fs0nPv,15,3,,1,15,3,,18
5125,privatansatte,35,9,,1,35,9,,44
5126,løstansatte,35,9,,1,35,9,,44
5127,Sygt,4,3,,1,4,3,,7
5128,miljøstyrelse,4,3,,1,4,3,,7
5129,miljøhensyn,4,3,,1,4,3,,7
5130,dkgreenMiljøstyrelsen,4,3,,1,4,3,,7
5131,milliardtab,4,3,,1,4,3,,7
5132,https://t.co/JdauMbkQiQ,4,3,,1,4,3,,7
5133,historiebøgerne,5,0,,1,5,0,,5
5134,praksis,21,4,,5,4,1,,25
5135,2019-virkeligheden,5,0,,1,5,0,,5
5136,tilstræbe,5,0,,1,5,0,,5
5137,lighed,17,1,,4,4,0,,18
5138,patriakalske,5,0,,1,5,0,,5
5139,syn,168,44,,7,24,6,,212
5140,whistleblowerordninger,91,9,,1,91,9,,100
5141,sladderhanke-kultur,91,9,,1,91,9,,100
5142,ønskeliste,91,9,,1,91,9,,100
5143,mv.,6,0,,2,3,0,,6
5144,Mañana-regeringen,9,4,,1,9,4,,13
5145,PSO-forhandlinger,9,4,,1,9,4,,13
5146,splittelse,335,18,,3,112,6,,353
5147,Europaudvalg,80,28,,2,40,14,,108
5148,EU-budget,52,15,,1,52,15,,67
5149,advokatfirma,128,29,,1,128,29,,157
5150,Sanjay,256,58,,2,128,29,,314
5151,Shah,256,58,,2,128,29,,314
5152,selvsamme,128,29,,1,128,29,,157
5153,udbytteskat,128,29,,1,128,29,,157
5154,https://t.co/oaZ5OlfIjF,128,29,,1,128,29,,157
5155,procentmålsætningen,7,2,,1,7,2,,9
5156,lovfæste,7,2,,1,7,2,,9
5157,Klimaloven,7,2,,1,7,2,,9
5158,energiforlig,9,3,,2,4,2,,12
5159,geotermi,6,3,,1,6,3,,9
5160,varmepumpe,6,3,,1,6,3,,9
5161,lavtemperaturområder,6,3,,1,6,3,,9
5162,billige,6,3,,1,6,3,,9
5163,energilagring,6,3,,1,6,3,,9
5164,https://t.co/dX1Hh0dODF,6,3,,1,6,3,,9
5165,slutte,292,62,,10,29,6,,354
5166,ulykke,8,2,,2,4,1,,10
5167,Ehl,4,2,,2,2,1,,6
5168,Miljømæssig,1,2,,1,1,2,,3
5169,taberregering,1,2,,1,1,2,,3
5170,klimahandlingsplaner,1,2,,2,0,1,,3
5171,https://t.co/SBcdeHWjj4,1,2,,1,1,2,,3
5172,Søndergaard,3,2,,1,3,2,,5
5173,mask,207,32,,2,104,16,,239
5174,dobbeltmoral,43,4,,3,14,1,,47
5175,https://t.co/gN22FsaSpi,3,2,,1,3,2,,5
5176,kampfly,92,10,,2,46,5,,102
5177,Uambitiøst,10,5,,1,10,5,,15
5178,skændsel,33,10,,3,11,3,,43
5179,https://t.co/dKTfHa1zBq,10,5,,1,10,5,,15
5180,Nødbremsen,103,3,,1,103,3,,106
5181,misvisende,103,3,,1,103,3,,106
5182,nød,150,9,,2,75,4,,159
5183,flugt,124,8,,2,62,4,,132
5184,sept,3,4,,1,3,4,,7
5185,Min.normeringer,3,4,,1,3,4,,7
5186,privatiseringsstop,3,4,,1,3,4,,7
5187,efterlyse,117,12,,3,39,4,,129
5188,http://t.co/RegYzQGGVk,3,4,,1,3,4,,7
5189,Finansministeren,0,0,,1,0,0,,0
5190,solcelleanlæg,0,0,,1,0,0,,0
5191,hovsa-indgreb,0,0,,1,0,0,,0
5192,https://t.co/d4W07EGj9x,0,0,,1,0,0,,0
5193,FRITID,64,1,,1,64,1,,65
5194,praktikpladsgaranti,39,16,,1,39,16,,55
5195,elevplads,39,16,,1,39,16,,55
5196,https://t.co/J7BBVmgMUm,39,16,,1,39,16,,55
5197,kemisk,2,2,,1,2,2,,4
5198,https://t.co/dusi2XeEpy,2,2,,1,2,2,,4
5199,slutning,96,12,,2,48,6,,108
5200,påskeferie,12,2,,1,12,2,,14
5201,generalforsamling,33,3,,3,11,1,,36
5202,Aaen,12,2,,1,12,2,,14
5203,https://t.co/uvHIZ1tmFK,12,2,,1,12,2,,14
5204,arbejdsløshedskøen,33,4,,1,33,4,,37
5205,jordisk,33,4,,1,33,4,,37
5206,fyreseddel,37,5,,2,18,2,,42
5207,https://t.co/opzUMlWM5h,33,4,,1,33,4,,37
5208,rigsret,12,3,,2,6,2,,15
5209,SFI,0,0,,1,0,0,,0
5210,privatliv,22,0,,3,7,0,,22
5211,oplysning,53,18,,6,9,3,,71
5212,Pippi-flyvning,0,0,,1,0,0,,0
5213,klagesag,15,1,,1,15,1,,16
5214,voksenhandicapområdet,15,1,,1,15,1,,16
5215,Else,176,27,,3,59,9,,203
5216,ift.,122,28,,7,17,4,,150
5217,SFO'er,0,0,,1,0,0,,0
5218,http://t.co/vIRHHJC9jo,0,0,,1,0,0,,0
5219,kvadratkilometer,151,16,,1,151,16,,167
5220,kurdisk,390,53,,3,130,18,,443
5221,hovedby,151,16,,1,151,16,,167
5222,Erdogan,239,37,,2,120,18,,276
5223,klovn,151,16,,1,151,16,,167
5224,https://t.co/dr90Cd90Lc,151,16,,1,151,16,,167
5225,laste,13,10,,1,13,10,,23
5226,Mærsk-skibe,26,20,,2,13,10,,46
5227,Arbejderne,13,10,,1,13,10,,23
5228,losse,24,10,,2,12,5,,34
5229,last,13,10,,1,13,10,,23
5230,Østafrikas,13,10,,1,13,10,,23
5231,havn,13,10,,1,13,10,,23
5232,papkasse,13,10,,1,13,10,,23
5233,container,13,10,,1,13,10,,23
5234,sikkerhedsudstyr,13,10,,1,13,10,,23
5235,Jaja,6,0,,1,6,0,,6
5236,straight,6,0,,1,6,0,,6
5237,face,210,30,,2,105,15,,240
5238,Jay-z,6,0,,1,6,0,,6
5239,klimalov,1040,74,,7,149,11,,1114
5240,sammenhæng,242,32,,12,20,3,,274
5241,kombinatører,17,4,,1,17,4,,21
5242,indkomstkategorier,17,4,,1,17,4,,21
5243,Oplagt,17,4,,1,17,4,,21
5244,Sjovt,141,15,,1,141,15,,156
5245,TV2-duellen,141,15,,1,141,15,,156
5246,understregning,141,15,,1,141,15,,156
5247,forandring,527,46,,9,59,5,,573
5248,massemyrderier,88,21,,1,88,21,,109
5249,Licensen,2,0,,1,2,0,,2
5250,progressiv,33,4,,3,11,1,,37
5251,tibet,105,12,,1,105,12,,117
5252,kapitalisme,401,21,,5,80,4,,422
5253,fidus,0,0,,1,0,0,,0
5254,bankpakkerne,0,0,,1,0,0,,0
5255,https://t.co/NA8Q4qi7Ef,0,0,,1,0,0,,0
5256,FGU-elever,27,5,,1,27,5,,32
5257,specialpædagogisk,58,8,,2,29,4,,66
5258,SPS,27,5,,1,27,5,,32
5259,FGU-eleverne,27,5,,1,27,5,,32
5260,FGU,65,14,,3,22,5,,79
5261,https://t.co/OSxmFPuv3y,27,5,,1,27,5,,32
5262,referere,1,0,,2,0,0,,1
5263,parole,6,1,,1,6,1,,7
5264,starthjælp,6,1,,1,6,1,,7
5265,klasse,490,37,,9,54,4,,527
5266,efterløn,63,14,,2,32,7,,77
5267,Regnemaskinen,14,5,,1,14,5,,19
5268,hælde,14,5,,1,14,5,,19
5269,pode,14,5,,1,14,5,,19
5270,Listen,14,5,,1,14,5,,19
5271,Progressive,14,5,,1,14,5,,19
5272,Podcast,20,9,,2,10,4,,29
5273,https://t.co/go8NNnC9YJ,14,5,,1,14,5,,19
5274,vrede,31,3,,2,16,2,,34
5275,skolebesparelser,2,1,,1,2,1,,3
5276,Større,2,1,,1,2,1,,3
5277,https://t.co/8VcSdLfzT7,2,1,,1,2,1,,3
5278,Radikales,1,0,,1,1,0,,1
5279,parlamentarisk,43,1,,7,6,0,,44
5280,værktøj,75,15,,2,38,8,,90
5281,corona-kriminalitet,16,1,,1,16,1,,17
5282,usandsynlig,36,7,,2,18,4,,43
5283,parallelaftale,7,2,,1,7,2,,9
5284,https://t.co/u1ZczsX2Tc,7,2,,1,7,2,,9
5285,afgiftslettelse,10,2,,2,5,1,,12
5286,partilederrunden,175,20,,1,175,20,,195
5287,Regningen,183,26,,2,92,13,,209
5288,finanskrise,416,39,,2,208,20,,455
5289,betale,175,20,,1,175,20,,195
5290,https://t.co/TU8o6QPx1L,175,20,,1,175,20,,195
5291,https://t.co/kPUh1bTLcP,0,1,,1,0,1,,1
5292,CO2-udslip,49,10,,2,24,5,,59
5293,landbrugsareal,36,6,,1,36,6,,42
5294,annimalske,36,6,,1,36,6,,42
5295,svinekød,36,6,,1,36,6,,42
5296,IPCC-klimarapport,36,6,,1,36,6,,42
5297,https://t.co/bTzejaVrK9,36,6,,1,36,6,,42
5298,færd,2,3,,1,2,3,,5
5299,grænseværdi,4,4,,2,2,2,,8
5300,Krom-6,2,3,,1,2,3,,5
5301,arbejder,9,9,,3,3,3,,18
5302,krisecenter,186,14,,2,93,7,,200
5303,dobbeltminoriteter,112,10,,1,112,10,,122
5304,fl21,125,16,,2,62,8,,141
5305,https://t.co/aY59edzQCw,112,10,,1,112,10,,122
5306,Velfærden,2,2,,1,2,2,,4
5307,privatisering,22,12,,2,11,6,,34
5308,ældrepleje,80,15,,6,13,2,,95
5309,velfærdtilsalg,2,2,,1,2,2,,4
5310,http://t.co/3ciJjv1TYs,2,2,,1,2,2,,4
5311,Split,206,38,,1,206,38,,244
5312,almennyttig,206,38,,1,206,38,,244
5313,finansiel,234,40,,4,58,10,,274
5314,sektor,528,73,,6,88,12,,601
5315,https://t.co/yfIL8R854,206,38,,1,206,38,,244
5316,Tjek,2,0,,1,2,0,,2
5317,https://t.co/lzo1xRdb4A,2,0,,1,2,0,,2
5318,Nørrebrobørn,54,5,,1,54,5,,59
5319,integrationsminister,54,5,,1,54,5,,59
5320,United,54,5,,1,54,5,,59
5321,https://t.co/b2HHWxa9rK,54,5,,1,54,5,,59
5322,foregangsland,53,15,,2,26,8,,68
5323,godkende,48,13,,1,48,13,,61
5324,olieudvinding,75,22,,2,38,11,,97
5325,oliejagt,168,42,,3,56,14,,210
5326,https://t.co/vJtKak3i96,48,13,,1,48,13,,61
5327,flygtningebarn,3,1,,1,3,1,,4
5328,https://t.co/qAQX1u8iow,3,1,,1,3,1,,4
5329,Anlægsloftet,1,0,,1,1,0,,1
5330,barriere,10,1,,2,5,0,,11
5331,https://t.co/Ds6cAiFHfP,0,1,,1,0,1,,1
5332,udbudsbetingelse,14,0,,1,14,0,,14
5333,fejagtige,14,0,,1,14,0,,14
5334,budgivere,14,0,,1,14,0,,14
5335,nejtilkampfly,11,4,,1,11,4,,15
5336,ATOMVÅBEN,2,2,,1,2,2,,4
5337,traske,2,2,,1,2,2,,4
5338,NATO,205,29,,5,41,6,,234
5339,atomvåben,2,2,,1,2,2,,4
5340,markering,113,18,,3,38,6,,131
5341,aktivitetsdag,4,1,,1,4,1,,5
5342,racisnm,4,1,,1,4,1,,5
5343,Silkeborg,82,17,,8,10,2,,99
5344,Musik,4,1,,1,4,1,,5
5345,fællessang,4,1,,1,4,1,,5
5346,Kulsort,1,0,,1,1,0,,1
5347,Konservativt,1,0,,1,1,0,,1
5348,nederlag,2,0,,2,1,0,,2
5349,https://t.co/OFI2Fwuwas,1,0,,1,1,0,,1
5350,stavefejl,19,2,,1,19,2,,21
5351,hår-dag,19,2,,1,19,2,,21
5352,regnemodeller,74,11,,2,37,6,,85
5353,antage,22,2,,1,22,2,,24
5354,vinterstøvle,22,2,,1,22,2,,24
5355,fremrykning,28,4,,1,28,4,,32
5356,ungdomsuddannelse,122,10,,4,30,2,,132
5357,https://t.co/M5sxfGLEtn,28,4,,1,28,4,,32
5358,https://t.co/SlNcduEvhR,152,16,,1,152,16,,168
5359,Aleppo-markering,1,2,,1,1,2,,3
5360,revision,1,2,,1,1,2,,3
5361,forretningsorden,1,2,,1,1,2,,3
5362,https://t.co/enVxZ5WHZc,1,2,,1,1,2,,3
5363,aleppo,1,2,,1,1,2,,3
5364,straksforbud,2,1,,1,2,1,,3
5365,hjernegiften,2,1,,1,2,1,,3
5366,clorphyrifos,2,1,,1,2,1,,3
5367,nul,64,10,,4,16,2,,74
5368,Skadeligt,2,1,,1,2,1,,3
5369,hjerne,580,39,,2,290,20,,619
5370,Fødevareministeren,2,1,,1,2,1,,3
5371,https://t.co/WbwHkjJhyT,2,1,,1,2,1,,3
5372,spor,19,7,,3,6,2,,26
5373,Arbejdstilsynet,13,7,,1,13,7,,20
5374,fyring,65,13,,4,16,3,,78
5375,systematisk,14,7,,2,7,4,,21
5376,arbejdsmiljøindsats,13,7,,1,13,7,,20
5377,smitteopsporing,9,1,,1,9,1,,10
5378,pandemien,9,1,,1,9,1,,10
5379,regional,73,13,,3,24,4,,86
5380,elbilsalget,0,1,,1,0,1,,1
5381,plantebaserede,81,7,,1,81,7,,88
5382,bøf,81,7,,1,81,7,,88
5383,burger,81,7,,1,81,7,,88
5384,patriarkalsk,50,8,,1,50,8,,58
5385,struktur,50,8,,1,50,8,,58
5386,https://t.co/iVZLrHAFUn,50,8,,1,50,8,,58
5387,voldsramt,74,4,,1,74,4,,78
5388,forhadt,76,14,,1,76,14,,90
5389,omprioriteringsbidrag,88,21,,2,44,10,,109
5390,https://t.co/4ccZtliajR,76,14,,1,76,14,,90
5391,Rohingyaerne,0,1,,1,0,1,,1
5392,https://t.co/0emqvy7gni,0,1,,1,0,1,,1
5393,Mjølnerparken,1,0,,1,1,0,,1
5394,havvindmøllepark,52,10,,1,52,10,,62
5395,https://t.co/fP4zqmShcN,52,10,,1,52,10,,62
5396,opfattelse,47,4,,2,24,2,,51
5397,Træls,9,7,,2,4,4,,16
5398,egentlig,16,7,,2,8,4,,23
5399,udviklingsbistand,112,37,,8,14,5,,149
5400,Nordskovvej,0,1,,1,0,1,,1
5401,https://t.co/ofYLA0exPj,0,1,,1,0,1,,1
5402,Besøget,2,1,,1,2,1,,3
5403,Uummannaq,2,1,,1,2,1,,3
5404,indtryk,204,50,,8,26,6,,254
5405,Nedsættelsen,7,6,,1,7,6,,13
5406,skoleydelse,7,6,,1,7,6,,13
5407,produktionsskole,7,6,,1,7,6,,13
5408,Fejlen,7,6,,1,7,6,,13
5409,arbejdsudbud,32,15,,3,11,5,,47
5410,ulighedsskabende,1,1,,1,1,1,,2
5411,https://t.co/Dk8eHfsok9,1,1,,1,1,1,,2
5412,opsøge,139,15,,1,139,15,,154
5413,https://t.co/0xw0NzSgIE,139,15,,1,139,15,,154
5414,røg,231,8,,3,77,3,,239
5415,kraftedme,523,26,,1,523,26,,549
5416,samtykkelov,531,26,,4,133,6,,557
5417,voldtægtsoffer,523,26,,1,523,26,,549
5418,https://t.co/tm2NYIHcWg,523,26,,1,523,26,,549
5419,information,127,23,,5,25,5,,150
5420,vigtighed,39,9,,1,39,9,,48
5421,samtykke,369,38,,5,74,8,,407
5422,frivillighed,39,9,,1,39,9,,48
5423,https://t.co/g61V6Dfrxv,39,9,,1,39,9,,48
5424,https://t.co/dKcJX84plz,32,7,,1,32,7,,39
5425,sengeplads,150,16,,1,150,16,,166
5426,krop,253,30,,5,51,6,,283
5427,sind,220,16,,4,55,4,,236
5428,https://t.co/2NDfMImNE5,150,16,,1,150,16,,166
5429,Ministerpost,4,1,,1,4,1,,5
5430,Pind,5,2,,3,2,1,,7
5431,Irakkommission,4,1,,1,4,1,,5
5432,familieterapi,4,1,,1,4,1,,5
5433,gyllegate,6,3,,2,3,2,,9
5434,Næppe,4,0,,2,2,0,,4
5435,Mængden,151,37,,1,151,37,,188
5436,pesticid,151,37,,1,151,37,,188
5437,drikkevandsboringer,151,37,,1,151,37,,188
5438,https://t.co/mkFQ8lMTnr,151,37,,1,151,37,,188
5439,Tibetsagen,35,8,,2,18,4,,43
5440,embedsmand,451,28,,5,90,6,,479
5441,Ministerier,2,1,,1,2,1,,3
5442,præsidium,0,1,,1,0,1,,1
5443,Færøerne,1,2,,2,0,1,,3
5444,præsidie,0,1,,1,0,1,,1
5445,østersproduktion,0,1,,1,0,1,,1
5446,Skaldyrs,0,1,,1,0,1,,1
5447,plastperlevirksomheden,0,1,,1,0,1,,1
5448,HAMA,0,1,,1,0,1,,1
5449,majoritet,0,1,,1,0,1,,1
5450,bøn,147,12,,1,147,12,,159
5451,parkeringsplads,147,12,,1,147,12,,159
5452,gymnasie,147,12,,1,147,12,,159
5453,Røde,1,1,,1,1,1,,2
5454,Grønne,55,12,,4,14,3,,67
5455,Nordisk,1,1,,1,1,1,,2
5456,https://t.co/U7sYGYsvgD,1,1,,1,1,1,,2
5457,nationalbank,1,0,,1,1,0,,1
5458,pegefinger,1,0,,1,1,0,,1
5459,byrod,2,2,,1,2,2,,4
5460,mellemstatslig,2,1,,1,2,1,,3
5461,liberalistisk,2,1,,1,2,1,,3
5462,udemokratisk,44,13,,2,22,6,,57
5463,åbenlys,577,26,,8,72,3,,603
5464,ulovlighed,1,0,,1,1,0,,1
5465,Slut,179,22,,8,22,3,,201
5466,dieselbil,44,8,,2,22,4,,52
5467,Merkur,0,1,,1,0,1,,1
5468,billig,221,26,,13,17,2,,247
5469,⁦En,0,1,,1,0,1,,1
5470,repræsentantskab,3,1,,2,2,0,,4
5471,https://t.co/7CxnaycrXC,0,1,,1,0,1,,1
5472,Afghanske,1,2,,1,1,2,,3
5473,tolk,1,2,,1,1,2,,3
5474,stikke,1,2,,1,1,2,,3
5475,Forlængelse,1,2,,1,1,2,,3
5476,https://t.co/272RgafNjW,1,2,,1,1,2,,3
5477,kriger,1,2,,1,1,2,,3
5478,Minimum,13,0,,1,13,0,,13
5479,borgerservice,13,0,,1,13,0,,13
5480,forrygende,0,1,,1,0,1,,1
5481,Forkostdebat,0,1,,1,0,1,,1
5482,https://t.co/vEAVotM4vn,0,1,,1,0,1,,1
5483,https://t.co/sZeNxVqCu3,2,3,,1,2,3,,5
5484,cyklisme,1,0,,1,1,0,,1
5485,cyklus,711,16,,2,356,8,,727
5486,befordring,1,0,,1,1,0,,1
5487,giftregn,1,0,,1,1,0,,1
5488,Prosulfocarp,1,0,,2,0,0,,1
5489,Flertallet,1,1,,1,1,1,,2
5490,Ankara-aftalen,1,1,,1,1,1,,2
5491,Erdogan-regimets,1,1,,1,1,1,,2
5492,styre,1,1,,1,1,1,,2
5493,Forreste,0,0,,1,0,0,,0
5494,venstre,43,8,,7,6,1,,51
5495,erhvervsstøtte,4,2,,1,4,2,,6
5496,https://t.co/T0p2L1pnnV,4,2,,1,4,2,,6
5497,Enig,112,15,,19,6,1,,127
5498,hvidvaskfri,35,5,,1,35,5,,40
5499,samfundsbank,41,5,,2,20,2,,46
5500,bord,241,34,,8,30,4,,275
5501,testregimet,24,1,,1,24,1,,25
5502,skud,656,35,,2,328,18,,691
5503,Sku,637,34,,1,637,34,,671
5504,budget,169,26,,6,28,4,,195
5505,Milliarder,28,13,,1,28,13,,41
5506,EU-centralisering,28,13,,1,28,13,,41
5507,støtteordning,28,13,,1,28,13,,41
5508,milliardregning,28,13,,1,28,13,,41
5509,suspension,2,0,,1,2,0,,2
5510,afsætte,166,24,,6,28,4,,190
5511,lønløft,2,0,,1,2,0,,2
5512,overenskomstforhandling,2,0,,1,2,0,,2
5513,takker!,10,0,,1,10,0,,10
5514,FLYGTNINGE,0,1,,1,0,1,,1
5515,EU-inst,0,1,,1,0,1,,1
5516,EU-opgave,0,1,,1,0,1,,1
5517,sammenligning,38,1,,4,10,0,,39
5518,Jelved,0,0,,1,0,0,,0
5519,Forsøg,17,10,,1,17,10,,27
5520,tvangsflytning,17,10,,1,17,10,,27
5521,https://t.co/Ef1x6i2JjT,17,10,,1,17,10,,27
5522,syre,0,0,,1,0,0,,0
5523,velvalgt,13,1,,1,13,1,,14
5524,tænksom,13,1,,1,13,1,,14
5525,kunstner,363,33,,4,91,8,,396
5526,Hærværket,13,1,,1,13,1,,14
5527,højtryksrenser,13,1,,1,13,1,,14
5528,https://t.co/n9wTZvgzME,13,1,,1,13,1,,14
5529,indgang,2,3,,1,2,3,,5
5530,Spændt,53,5,,2,26,2,,58
5531,https://t.co/Dh6qHWwaqm,2,3,,1,2,3,,5
5532,Arbejdsløsheden,9,3,,1,9,3,,12
5533,vejr,101,22,,4,25,6,,123
5534,Tusinder,11,4,,2,6,2,,15
5535,arbejdsløshed,97,13,,4,24,3,,110
5536,Højere,9,3,,1,9,3,,12
5537,dagpengedsats,9,3,,1,9,3,,12
5538,https://t.co/s0gsZbYtKX,9,3,,1,9,3,,12
5539,forsøgsordning,2,1,,1,2,1,,3
5540,mindske,2,1,,2,1,0,,3
5541,dataindsamling,2,1,,1,2,1,,3
5542,https://t.co/JYXOz6lxX1,2,1,,1,2,1,,3
5543,murer,11,7,,1,11,7,,18
5544,SOSU-assistenten,11,7,,1,11,7,,18
5545,tilfreds,15,8,,3,5,3,,23
5546,ftive,11,7,,1,11,7,,18
5547,MILLITÆRUDGIFTER,0,1,,1,0,1,,1
5548,https://t.co/EvhaF14ykJ,0,1,,1,0,1,,1
5549,Tirsdag,3,1,,1,3,1,,4
5550,valgduel,3,1,,1,3,1,,4
5551,TV2ØST,3,1,,1,3,1,,4
5552,valgoplæg,10,3,,1,10,3,,13
5553,luft,36,5,,5,7,1,,41
5554,Klimaproblemer,10,3,,1,10,3,,13
5555,klimarådets,31,6,,3,10,2,,37
5556,https://t.co/eOJBrqQOyY,10,3,,1,10,3,,13
5557,ligestilling,798,103,,15,53,7,,901
5558,bedsteforældre,464,25,,2,232,12,,489
5559,minimumsnormeringernu,461,25,,1,461,25,,486
5560,Nix,6,2,,1,6,2,,8
5561,Værditillæg,6,2,,1,6,2,,8
5562,luksustillæg,6,2,,1,6,2,,8
5563,Nemt,6,2,,1,6,2,,8
5564,Hvornår,28,6,,3,9,2,,34
5565,DBU,0,0,,1,0,0,,0
5566,sten,238,40,,3,79,13,,278
5567,Hamborg,220,38,,1,220,38,,258
5568,taletid,220,38,,1,220,38,,258
5569,G20protests,220,38,,1,220,38,,258
5570,Skæv,10,6,,1,10,6,,16
5571,https://t.co/J9AsVwYxKf,4,1,,1,4,1,,5
5572,https://t.co/8ACGKCxHYT,2,0,,1,2,0,,2
5573,Topskattelettelserne,163,17,,1,163,17,,180
5574,feriepenge,163,17,,1,163,17,,180
5575,https://t.co/rrQOawVzm3,163,17,,1,163,17,,180
5576,Holger,8,3,,1,8,3,,11
5577,EU-kritik,8,3,,1,8,3,,11
5578,højrenationalisterne,8,3,,1,8,3,,11
5579,https://t.co/cOgRr35pAK,8,3,,1,8,3,,11
5580,Syltekrykke,21,6,,1,21,6,,27
5581,CO2-afgift,21,6,,1,21,6,,27
5582,grotesk,107,12,,4,27,3,,119
5583,overkompensation,21,6,,1,21,6,,27
5584,skattereform,21,6,,1,21,6,,27
5585,klimasvigt,21,6,,1,21,6,,27
5586,https://t.co/jpgFovF2lQ,21,6,,1,21,6,,27
5587,nårh,6,1,,1,6,1,,7
5588,detbaregas,6,1,,1,6,1,,7
5589,fiskekutter,4,2,,1,4,2,,6
5590,Anton,4,2,,1,4,2,,6
5591,intiativtager,4,2,,1,4,2,,6
5592,Levende,4,2,,1,4,2,,6
5593,Hav,4,2,,1,4,2,,6
5594,miljøaktivist,4,2,,1,4,2,,6
5595,Andersen,9,2,,2,4,1,,11
5596,https://t.co/IuEJ0yMVqH,4,2,,1,4,2,,6
5597,Horns,27,3,,1,27,3,,30
5598,Rev,27,3,,1,27,3,,30
5599,Sande,27,3,,1,27,3,,30
5600,Parken,27,3,,1,27,3,,30
5601,husstand,97,20,,5,19,4,,117
5602,⁦@Enhedslisten⁩,31,5,,2,16,2,,36
5603,havvindmølleparker,27,3,,1,27,3,,30
5604,Vedvarende,27,3,,1,27,3,,30
5605,https://t.co/e2FAqi4e3N,27,3,,1,27,3,,30
5606,Bagstræberisk,1,0,,1,1,0,,1
5607,gymnasieudspil,1,0,,1,1,0,,1
5608,https://t.co/m8OWmlXh1h,1,0,,1,1,0,,1
5609,lt;3,3,1,,2,2,0,,4
5610,baron,7,4,,1,7,4,,11
5611,seng,14,8,,2,7,4,,22
5612,kvotekongens,7,4,,1,7,4,,11
5613,kvotekongerne,7,4,,1,7,4,,11
5614,Kvotekonge,7,4,,1,7,4,,11
5615,https://t.co/57FIKg5i6E,7,4,,1,7,4,,11
5616,⁦@Enhedslisten,56,6,,1,56,6,,62
5617,politiforhandlingerne,56,6,,1,56,6,,62
5618,https://t.co/EUovdmPKnO,56,6,,1,56,6,,62
5619,Varme,186,10,,4,46,2,,196
5620,https://t.co/W54LkwXw9w,46,5,,1,46,5,,51
5621,præcis,236,14,,3,79,5,,250
5622,lovbrud,522,39,,3,174,13,,561
5623,bødeblokken,0,0,,1,0,0,,0
5624,relevant,100,7,,6,17,1,,107
5625,nuværende,739,66,,14,53,5,,805
5626,navnkundig,21,6,,1,21,6,,27
5627,SKÆV-kampagne,21,6,,1,21,6,,27
5628,https://t.co/wUMMCqLLAy,21,6,,1,21,6,,27
5629,kapitalfonde,24,7,,1,24,7,,31
5630,https://t.co/S37g6rSnge,24,7,,1,24,7,,31
5631,vismand,73,19,,2,36,10,,92
5632,klimaministeren,69,19,,1,69,19,,88
5633,https://t.co/TFjM3dBBb2,69,19,,1,69,19,,88
5634,rød-grøn,22,2,,1,22,2,,24
5635,ikke-udlændinge,5,0,,1,5,0,,5
5636,Anker,328,47,,4,82,12,,375
5637,Jørgensens,162,25,,2,81,12,,187
5638,undet,10,6,,1,10,6,,16
5639,gyldne,3,0,,1,3,0,,3
5640,håndtryk,14,0,,3,5,0,,14
5641,nære,8,2,,3,3,1,,10
5642,Gak,19,1,,1,19,1,,20
5643,uddannelsesministeren,19,1,,1,19,1,,20
5644,tilsvarende,109,9,,6,18,2,,118
5645,folkeafstemning,196,42,,3,65,14,,238
5646,https://t.co/0rlImN3uEO,1,4,,1,1,4,,5
5647,Strategien,11,0,,1,11,0,,11
5648,Fremføring,0,1,,1,0,1,,1
5649,underskud,26,3,,6,4,0,,29
5650,tab,6,2,,2,3,1,,8
5651,skatteudgift,0,1,,1,0,1,,1
5652,omsætning,6,0,,1,6,0,,6
5653,https://t.co/F4CmhkRWC1,6,0,,1,6,0,,6
5654,PET,423,24,,5,85,5,,447
5655,højprofilerede,4,1,,1,4,1,,5
5656,efterretninsgtjenesterne,4,1,,1,4,1,,5
5657,afkræfte,8,0,,1,8,0,,8
5658,https://t.co/I2k0QlI1bF,28,4,,1,28,4,,32
5659,ministeren.#dkpol,0,0,,1,0,0,,0
5660,Bernie,419,26,,2,210,13,,445
5661,Værtshusslagsmål,5,0,,1,5,0,,5
5662,automatik,23,4,,2,12,2,,27
5663,Tvangsfjernelse,5,0,,1,5,0,,5
5664,Detailstyringen,19,2,,1,19,2,,21
5665,symbolpolitik,226,20,,5,45,4,,246
5666,Vinhanen,2,0,,1,2,0,,2
5667,rosé,2,0,,1,2,0,,2
5668,Stigende,13,4,,1,13,4,,17
5669,håndbremse,13,4,,1,13,4,,17
5670,energipolitik,32,27,,2,16,14,,59
5671,klimaindsats,13,4,,1,13,4,,17
5672,ruin,165,28,,2,82,14,,193
5673,Hilsen,87,13,,1,87,13,,100
5674,nørrebro,87,13,,1,87,13,,100
5675,https://t.co/YDbQgO87mV,2,0,,1,2,0,,2
5676,Ørestad,139,20,,3,46,7,,159
5677,Gymnasiums,94,15,,1,94,15,,109
5678,stilling,326,36,,7,47,5,,362
5679,forhandlingsleder,1,0,,1,1,0,,1
5680,guldregn,58,6,,1,58,6,,64
5681,https://t.co/cFfY6ezEit,58,6,,1,58,6,,64
5682,ulandsbistand,27,11,,3,9,4,,38
5683,https://t.co/fg0hehlBqS,6,3,,1,6,3,,9
5684,Kulturministeren,1,0,,1,1,0,,1
5685,tilstand,436,39,,9,48,4,,475
5686,https://t.co/QjqDzkk5hY,4,1,,1,4,1,,5
5687,DF-afsløring,0,0,,1,0,0,,0
5688,EU-konference,0,0,,1,0,0,,0
5689,https://t.co/Vv5KeXsDct,0,0,,1,0,0,,0
5690,Minister,1,0,,2,0,0,,1
5691,frugt,43,4,,3,14,1,,47
5692,https://t.co/FIh9qv5DFN,0,0,,1,0,0,,0
5693,utrættelig,85,13,,2,42,6,,98
5694,Ø-miljøordførere,74,12,,1,74,12,,86
5695,Roundup,75,12,,2,38,6,,87
5696,totalforbud,74,12,,1,74,12,,86
5697,bekæmpe,13,6,,1,13,6,,19
5698,https://t.co/GydDSeRQvt,13,6,,1,13,6,,19
5699,meningsløs,74,5,,2,37,2,,79
5700,kalkule,0,0,,1,0,0,,0
5701,ParadisePapers,47,13,,1,47,13,,60
5702,rigestes,47,13,,1,47,13,,60
5703,grådighed,111,21,,3,37,7,,132
5704,gemme,47,13,,1,47,13,,60
5705,skattely,150,48,,7,21,7,,198
5706,ejerskab,31,7,,1,31,7,,38
5707,https://t.co/L4rJaRjcTf,1,0,,1,1,0,,1
5708,Utilfredsheden,1,1,,1,1,1,,2
5709,Debatmøde,8,5,,1,8,5,,13
5710,Varde,8,5,,1,8,5,,13
5711,højspændingsmast,8,5,,1,8,5,,13
5712,Viking,8,5,,1,8,5,,13
5713,Link,87,10,,2,44,5,,97
5714,kabel,8,5,,1,8,5,,13
5715,CO2-mæssigt,8,5,,1,8,5,,13
5716,konkurrence,47,11,,9,5,1,,58
5717,CO2-reduktioner,8,5,,1,8,5,,13
5718,opsporing,23,3,,1,23,3,,26
5719,sundhedsansvarlig,23,3,,1,23,3,,26
5720,klimaplan,54,12,,3,18,4,,66
5721,periodisk,5,1,,1,5,1,,6
5722,https://t.co/6l0xiGCVKd,5,1,,1,5,1,,6
5723,velfærdsgaranti,206,34,,1,206,34,,240
5724,sygehus,274,47,,9,30,5,,321
5725,https://t.co/3fOugea3PZ,206,34,,1,206,34,,240
5726,Godhedsindustrien,2,2,,1,2,2,,4
5727,DFere,2,2,,1,2,2,,4
5728,tiltale,2,2,,1,2,2,,4
5729,Pas,8,1,,1,8,1,,9
5730,Stinus,96,4,,2,48,2,,100
5731,https://t.co/C4G5ogGfs6,14,1,,1,14,1,,15
5732,trulyscandinavian,4,0,,1,4,0,,4
5733,Stensætning,4,0,,1,4,0,,4
5734,marksten,4,0,,1,4,0,,4
5735,istid,4,0,,1,4,0,,4
5736,klimabelastende,19,2,,2,10,1,,21
5737,granit,4,0,,1,4,0,,4
5738,betonfliser,4,0,,1,4,0,,4
5739,Trivslen,4,1,,1,4,1,,5
5740,dispensation,7,2,,3,2,1,,9
5741,knæ,819,103,,2,410,52,,922
5742,Hjerteskærende,793,99,,2,396,50,,892
5743,JusticeForGeorgeFloyd,786,98,,1,786,98,,884
5744,https://t.co/3A9dRiCPmo,786,98,,1,786,98,,884
5745,LORTEDOMMER,27,0,,1,27,0,,27
5746,BIFFCM,27,0,,1,27,0,,27
5747,Afventer,0,0,,1,0,0,,0
5748,Klimatopmøde,0,0,,1,0,0,,0
5749,Tibetsag,0,0,,1,0,0,,0
5750,Børnenes,9,0,,1,9,0,,9
5751,Grundlovsdag,9,0,,1,9,0,,9
5752,https://t.co/maeOelm7wb,9,0,,1,9,0,,9
5753,PETs,0,1,,1,0,1,,1
5754,retssag,9,1,,2,4,0,,10
5755,Solen,665,17,,1,665,17,,682
5756,Bank,669,18,,2,334,9,,687
5757,udbytte,665,17,,1,665,17,,682
5758,privatiseringsplan,107,25,,1,107,25,,132
5759,indtjening,159,39,,2,80,20,,198
5760,skidt,114,28,,2,57,14,,142
5761,https://t.co/FuIyLOuaty,107,25,,1,107,25,,132
5762,ansøger,187,16,,3,62,5,,203
5763,sprogprøve,2,0,,1,2,0,,2
5764,vagthund,12,2,,1,12,2,,14
5765,https://t.co/OQmImvCTex,12,2,,1,12,2,,14
5766,begunstigelse,4,0,,1,4,0,,4
5767,forlænge,4,0,,1,4,0,,4
5768,sendetilladelse,4,0,,1,4,0,,4
5769,udbudsproces,4,0,,1,4,0,,4
5770,voldspsykopater,32,5,,1,32,5,,37
5771,højrefløjsregering,32,5,,1,32,5,,37
5772,tough,32,5,,1,32,5,,37
5773,crime,32,5,,1,32,5,,37
5774,https://t.co/gPBugy0yoh,32,5,,1,32,5,,37
5775,Statsministerens,73,2,,3,24,1,,75
5776,lilla,4,0,,1,4,0,,4
5777,https://t.co/igmPh5AfEV,4,0,,1,4,0,,4
5778,Hudlidelser,1,1,,1,1,1,,2
5779,Beskæftigelsesministeren,1,1,,1,1,1,,2
5780,https://t.co/EmiY8sQqsp,1,1,,1,1,1,,2
5781,kulturområde,1,1,,1,1,1,,2
5782,overklasse,1,1,,2,0,0,,2
5783,https://t.co/QdOyYcrPCf,1,1,,1,1,1,,2
5784,Rigsrevisionen,36,1,,3,12,0,,37
5785,DAB-udbud,26,0,,1,26,0,,26
5786,https://t.co/7Xk5sqiH33,26,0,,1,26,0,,26
5787,KVALME,10,3,,1,10,3,,13
5788,LAs,12,3,,2,6,2,,15
5789,Skamløs,10,3,,1,10,3,,13
5790,egoisme,10,3,,1,10,3,,13
5791,https://t.co/fSCXF5gysO,10,3,,1,10,3,,13
5792,Orangebilletterne,0,0,,2,0,0,,0
5793,fly,2,0,,2,1,0,,2
5794,ENDELIG,64,12,,2,32,6,,76
5795,whistleblower,33,7,,1,33,7,,40
5796,https://t.co/iZ9vPpeWKo,33,7,,1,33,7,,40
5797,Fælleseje,25,0,,1,25,0,,25
5798,statseje,25,0,,1,25,0,,25
5799,forbrugereje,25,0,,1,25,0,,25
5800,medarbejdereje,25,0,,1,25,0,,25
5801,eje,25,0,,2,12,0,,25
5802,skandaløs,361,44,,2,180,22,,405
5803,retskrav,1,0,,1,1,0,,1
5804,ledsagelse,1,0,,1,1,0,,1
5805,⁦@MLundbyHansen⁩,156,18,,1,156,18,,174
5806,moder,156,18,,1,156,18,,174
5807,kærlig,156,18,,1,156,18,,174
5808,møllesten,156,18,,1,156,18,,174
5809,https://t.co/PNyIJlYjIZ,156,18,,1,156,18,,174
5810,man.,298,22,,3,99,7,,320
5811,slippe,1,0,,1,1,0,,1
5812,Ældreområdet,11,4,,1,11,4,,15
5813,topskattelettelser,134,22,,2,67,11,,156
5814,https://t.co/eo9bbkBM3D,129,22,,1,129,22,,151
5815,rugbrød,131,17,,2,66,8,,148
5816,receptpligtig,131,17,,1,131,17,,148
5817,prisstabilitet,131,17,,1,131,17,,148
5818,https://t.co/MVTcAdT684,131,17,,1,131,17,,148
5819,stoleryg,0,0,,1,0,0,,0
5820,Skat,354,27,,4,88,7,,381
5821,udøve,4,0,,1,4,0,,4
5822,andelsboligvurderinger,42,4,,1,42,4,,46
5823,Aggressive,42,4,,1,42,4,,46
5824,valuare,42,4,,1,42,4,,46
5825,prisniveau,42,4,,1,42,4,,46
5826,boligmarked,42,4,,1,42,4,,46
5827,dep.chef,2,0,,1,2,0,,2
5828,styrkeforhold,0,0,,1,0,0,,0
5829,fagbevægelse,29,8,,5,6,2,,37
5830,selvisolation,37,7,,1,37,7,,44
5831,karantæne,37,7,,1,37,7,,44
5832,pga,37,7,,1,37,7,,44
5833,https://t.co/pApLgP6g15,37,7,,1,37,7,,44
5834,oprids,13,0,,1,13,0,,13
5835,Støjberg-sagen,13,0,,1,13,0,,13
5836,FGU'en,31,3,,1,31,3,,34
5837,FGU-skolerne,31,3,,1,31,3,,34
5838,Linke,2,0,,1,2,0,,2
5839,FLordfører,3,1,,1,3,1,,4
5840,https://t.co/1xdF3EuNkk,3,1,,1,3,1,,4
5841,konge,53,1,,4,13,0,,54
5842,Nordpolen,4,0,,1,4,0,,4
5843,udsendelse,21,2,,4,5,0,,23
5844,service-kanal,4,0,,1,4,0,,4
5845,forsvare,60,5,,2,30,2,,65
5846,FL20,201,22,,3,67,7,,223
5847,https://t.co/76yqeThfj9,28,0,,1,28,0,,28
5848,Dont,1,6,,1,1,6,,7
5849,question,1,6,,1,1,6,,7
5850,that,170,58,,4,42,14,,228
5851,created,1,6,,1,1,6,,7
5852,unequal,1,6,,1,1,6,,7
5853,world,2632,856,,3,877,285,,3488
5854,DKTalkPost2015,1,6,,1,1,6,,7
5855,voldtægts-overlevere,196,20,,1,196,20,,216
5856,https://t.co/4718K20o9Q,196,20,,1,196,20,,216
5857,føde,9,0,,2,4,0,,9
5858,fødsel,3,0,,1,3,0,,3
5859,svangreomsorgen,3,0,,1,3,0,,3
5860,villig,3,0,,1,3,0,,3
5861,https://t.co/ABmzLBVApZ,3,0,,1,3,0,,3
5862,ineffektiv,7,4,,1,7,4,,11
5863,erhvervstilskud,7,4,,1,7,4,,11
5864,https://t.co/RbzLzDvoih,7,4,,1,7,4,,11
5865,Nååå,85,0,,2,42,0,,85
5866,Sandt,2,1,,2,1,0,,3
5867,apps,0,0,,1,0,0,,0
5868,elforbrug,4,4,,1,4,4,,8
5869,Dårlig,4,4,,1,4,4,,8
5870,planlægning,4,4,,1,4,4,,8
5871,datacenter,4,4,,1,4,4,,8
5872,overskudsvarme,4,4,,1,4,4,,8
5873,Lovene,4,4,,1,4,4,,8
5874,vedvare,38,15,,3,13,5,,53
5875,butik,1,0,,2,0,0,,1
5876,optimal,1,0,,1,1,0,,1
5877,betingelse,21,3,,2,10,2,,24
5878,børneliv,1,0,,1,1,0,,1
5879,Klimaplan,53,10,,1,53,10,,63
5880,eksplosion,62,10,,4,16,2,,72
5881,skæv,53,10,,1,53,10,,63
5882,Vejen,59,14,,2,30,7,,73
5883,retfærdig.#dkpol,53,10,,1,53,10,,63
5884,mindretal,186,13,,3,62,4,,199
5885,Slesvig-Holsten,3,1,,1,3,1,,4
5886,Hotel,3,1,,1,3,1,,4
5887,Nordens,3,1,,1,3,1,,4
5888,kilometer,52,4,,3,17,1,,56
5889,dansk-tysk,3,1,,1,3,1,,4
5890,Partiets,3,1,,1,3,1,,4
5891,SSW,3,1,,1,3,1,,4
5892,https://t.co/pETVlLn9gW,3,1,,1,3,1,,4
5893,Eduardo,39,14,,1,39,14,,53
5894,Vistisen,39,14,,1,39,14,,53
5895,dovne,39,14,,1,39,14,,53
5896,https://t.co/tr1mjHVdWg,39,14,,1,39,14,,53
5897,Johannes,1,0,,1,1,0,,1
5898,tekop,1,0,,1,1,0,,1
5899,https://t.co/HUeK9rKpRe,4,1,,1,4,1,,5
5900,Bomtrawl,21,8,,1,21,8,,29
5901,Natura,22,8,,2,11,4,,30
5902,imødekomme,21,8,,1,21,8,,29
5903,https://t.co/AYXRiOdQ7,21,8,,1,21,8,,29
5904,sksl,3,0,,1,3,0,,3
5905,Karnov,3,0,,2,2,0,,3
5906,Regeringeen+DF+S+SF,14,9,,1,14,9,,23
5907,boligområde,17,10,,4,4,2,,27
5908,ghettolister,14,9,,1,14,9,,23
5909,målstolpe,14,9,,1,14,9,,23
5910,ang,14,9,,1,14,9,,23
5911,Sundparken,14,9,,1,14,9,,23
5912,Horsens,17,10,,3,6,3,,27
5913,almenmodstand,14,9,,1,14,9,,23
5914,optjeningskrav,0,0,,1,0,0,,0
5915,skammelig,46,6,,1,46,6,,52
5916,https://t.co/98HJhEUupU,46,6,,1,46,6,,52
5917,MændTaler,3,0,,1,3,0,,3
5918,https://t.co/7O0w6vtPWH,3,0,,1,3,0,,3
5919,https://t.co/Ma5VpfwRkg,7,1,,1,7,1,,8
5920,havbrug,39,15,,3,13,5,,54
5921,kvælstof,13,5,,1,13,5,,18
5922,Udskældt,13,5,,1,13,5,,18
5923,overskridelse,13,5,,2,6,2,,18
5924,DAGEN,1,2,,1,1,2,,3
5925,smitteopsporingen,29,4,,1,29,4,,33
5926,coronadk,29,4,,1,29,4,,33
5927,https://t.co/Q1kAg2snR1,29,4,,1,29,4,,33
5928,UKIP,0,0,,1,0,0,,0
5929,SF's,0,0,,2,0,0,,0
5930,nej-siger,0,0,,1,0,0,,0
5931,refleksion,0,0,,1,0,0,,0
5932,legetøj,13,1,,1,13,1,,14
5933,badekaret,13,1,,1,13,1,,14
5934,Deltag,0,1,,1,0,1,,1
5935,Fornuftigt,34,5,,1,34,5,,39
5936,sundhedsfaglig,168,15,,6,28,2,,183
5937,gruppere,129,23,,5,26,5,,152
5938,drastisk,34,5,,1,34,5,,39
5939,Sikkerhed,0,1,,1,0,1,,1
5940,fiskeskibe,0,1,,1,0,1,,1
5941,Riverboat,2,1,,1,2,1,,3
5942,Jazzfestival,2,1,,1,2,1,,3
5943,stable,2,1,,1,2,1,,3
5944,sommerfest,2,1,,1,2,1,,3
5945,23.,31,1,,2,16,0,,32
5946,Nyvalgte,2,1,,1,2,1,,3
5947,MFer,2,1,,1,2,1,,3
5948,Villadsen,2,1,,1,2,1,,3
5949,Per,62,9,,4,16,2,,71
5950,Monnerup,2,1,,1,2,1,,3
5951,Region,35,6,,3,12,2,,41
5952,tværfaglig,4,2,,1,4,2,,6
5953,psykiatrihandlingsplan,4,2,,1,4,2,,6
5954,https://t.co/qUsIEVlQc5,4,2,,1,4,2,,6
5955,Pasok,1,2,,1,1,2,,3
5956,Aron,1,1,,1,1,1,,2
5957,Grønlandske,1,1,,1,1,1,,2
5958,myte,212,29,,3,71,10,,241
5959,https://t.co/6V4GZVgJNI,1,1,,1,1,1,,2
5960,svaghed,5,1,,1,5,1,,6
5961,Finanslovs-forliget,5,1,,1,5,1,,6
5962,på.#dkpol,3,2,,1,3,2,,5
5963,https://t.co/7AAk2P9Npe,3,2,,1,3,2,,5
5964,begå,137,20,,1,137,20,,157
5965,Psykiatrien,137,20,,1,137,20,,157
5966,vegetar,30,4,,2,15,2,,34
5967,Klimahensyn,14,1,,1,14,1,,15
5968,https://t.co/eLpKYPO6eo,14,1,,1,14,1,,15
5969,masse,33,6,,6,6,1,,39
5970,https://t.co/nkRZ27wOm7,0,1,,1,0,1,,1
5971,straffelovrådet,19,1,,1,19,1,,20
5972,substantiel,19,1,,1,19,1,,20
5973,begreb,19,1,,1,19,1,,20
5974,tilhænger,105,1,,2,52,0,,106
5975,Zetland,12,1,,1,12,1,,13
5976,bunkeanmelder,12,1,,1,12,1,,13
5977,Særlige,12,1,,2,6,0,,13
5978,kendetegn,12,1,,2,6,0,,13
5979,sjov,833,81,,14,60,6,,914
5980,Humoren,12,1,,1,12,1,,13
5981,vid,12,1,,1,12,1,,13
5982,forfatter,147,25,,3,49,8,,172
5983,selvironi,12,1,,1,12,1,,13
5984,stands,12,1,,1,12,1,,13
5985,finde,39,2,,1,39,2,,41
5986,irritere,55,4,,3,18,1,,59
5987,viljeløs,39,2,,1,39,2,,41
5988,troll,117,6,,3,39,2,,123
5989,lyskilde,39,2,,1,39,2,,41
5990,Gold,39,2,,1,39,2,,41
5991,Mindre,51,14,,4,13,4,,65
5992,mudderkast,7,2,,1,7,2,,9
5993,substans,7,3,,2,4,2,,10
5994,Hatten,7,2,,1,7,2,,9
5995,Alex,66,10,,2,33,5,,76
5996,petroleum,14,0,,1,14,0,,14
5997,engangsudgift,14,0,,1,14,0,,14
5998,jernbane,55,13,,3,18,4,,68
5999,Vejle,37,11,,4,9,3,,48
6000,Billund,14,0,,1,14,0,,14
6001,There,3,1,,1,3,1,,4
6002,can,318,82,,7,45,12,,400
6003,only,25,20,,3,8,7,,45
6004,one,24,18,,2,12,9,,42
6005,opinion,53,3,,2,26,2,,56
6006,https://t.co/QVqSoOuk50,3,1,,1,3,1,,4
6007,Mailsvar,2,0,,1,2,0,,2
6008,Journalistisk,4,0,,2,2,0,,4
6009,ideal,11,1,,2,6,0,,12
6010,fortid,116,9,,3,39,3,,125
6011,turné,5,2,,1,5,2,,7
6012,Ræson,5,2,,1,5,2,,7
6013,https://t.co/rvr92fEsRw,5,2,,1,5,2,,7
6014,Sydkorea,72,2,,3,24,1,,74
6015,inddæmme,34,1,,1,34,1,,35
6016,resolut,34,1,,1,34,1,,35
6017,https://t.co/ArvPtqLoWA,17,4,,1,17,4,,21
6018,skolevalg,25,3,,3,8,1,,28
6019,http://t.co/pXYR4hyLiN,1,2,,1,1,2,,3
6020,Jørgensen,264,44,,5,53,9,,308
6021,Michael,80,6,,5,16,1,,86
6022,Birkjær,2,1,,1,2,1,,3
6023,Dans,2,1,,1,2,1,,3
6024,Stauning,2,1,,1,2,1,,3
6025,https://t.co/KAqlk5ulf1,2,1,,1,2,1,,3
6026,flå,37,4,,1,37,4,,41
6027,klo,37,4,,1,37,4,,41
6028,Baumols,0,0,,1,0,0,,0
6029,Gunnar,0,0,,1,0,0,,0
6030,Viby,0,0,,1,0,0,,0
6031,Mogensens,0,0,,1,0,0,,0
6032,hovedværk,0,0,,1,0,0,,0
6033,velfærdsstat,5,2,,3,2,1,,7
6034,Jeff,273,5,,1,273,5,,278
6035,Bezo,273,5,,1,273,5,,278
6036,opildne,273,5,,1,273,5,,278
6037,splid,273,5,,1,273,5,,278
6038,kørestrøm,0,0,,1,0,0,,0
6039,fodboldspiller,12,3,,2,6,2,,15
6040,tank,631,40,,8,79,5,,671
6041,https://t.co/Wz7jgKJBf6,376,16,,1,376,16,,392
6042,Valgkamp,73,13,,3,24,4,,86
6043,grafik,6,5,,2,3,2,,11
6044,http://t.co/JV4qcO41kc,5,4,,1,5,4,,9
6045,højdepunkt,21,2,,2,10,1,,23
6046,LALM18,21,2,,1,21,2,,23
6047,jøde,119,24,,3,40,8,,143
6048,yderst,854,34,,4,214,8,,888
6049,nynazist,20,0,,1,20,0,,20
6050,Magtens,23,14,,2,12,7,,37
6051,tredeling,23,14,,2,12,7,,37
6052,Sjov,4,6,,1,4,6,,10
6053,liberalungdom,13,11,,2,6,6,,24
6054,http://t.co/pKRUlWjcMo,4,6,,1,4,6,,10
6055,Børnetilskud,1,0,,1,1,0,,1
6056,Meritokrati,32,3,,1,32,3,,35
6057,søjle,32,3,,1,32,3,,35
6058,blyant,32,3,,1,32,3,,35
6059,meritokrati,32,3,,1,32,3,,35
6060,Ole,8,3,,3,3,1,,11
6061,https://t.co/Z3jSZT8Ff4,23,0,,2,12,0,,23
6062,Toppen,4,1,,1,4,1,,5
6063,provinsiel,4,1,,1,4,1,,5
6064,udland,49,14,,3,16,5,,63
6065,https://t.co/kgozKLQGFJ,4,1,,1,4,1,,5
6066,boligminister,48,3,,1,48,3,,51
6067,Liberale,58,10,,2,29,5,,68
6068,https://t.co/v9io5UrjaX,48,3,,1,48,3,,51
6069,Bonde,44,4,,1,44,4,,48
6070,Skov,44,4,,1,44,4,,48
6071,finger,22,7,,2,11,4,,29
6072,mekanisk,4,1,,1,4,1,,5
6073,genstand,87,8,,3,29,3,,95
6074,Nasseri,31,9,,1,31,9,,40
6075,samfundsproblem,31,9,,1,31,9,,40
6076,https://t.co/YD4ccDwJFS,31,9,,1,31,9,,40
6077,klokke,62,13,,6,10,2,,75
6078,passe,104,12,,5,21,2,,116
6079,fattigdomsafgifter,17,0,,1,17,0,,17
6080,screeningsproces,35,0,,1,35,0,,35
6081,Håndtrykslovgivning,35,0,,1,35,0,,35
6082,kronologi,3,1,,1,3,1,,4
6083,mia,309,59,,17,18,3,,368
6084,https://t.co/UExOq1DDE8,19,1,,1,19,1,,20
6085,Islamisterne,2,0,,1,2,0,,2
6086,sekulær,2,0,,1,2,0,,2
6087,http://t.co/AgJvGqHRi8,2,0,,1,2,0,,2
6088,sønderborg,2,0,,1,2,0,,2
6089,Australien,11,8,,2,6,4,,19
6090,Schweiz,20,9,,2,10,4,,29
6091,Canada,20,8,,2,10,4,,28
6092,Futtrup,20,4,,1,20,4,,24
6093,ensom,22,4,,2,11,2,,26
6094,ideologisk,26,5,,2,13,2,,31
6095,Keep,20,4,,1,20,4,,24
6096,LAULM16,27,6,,2,14,3,,33
6097,80-året,67,13,,1,67,13,,80
6098,Krystalnatten,67,13,,1,67,13,,80
6099,Angela,186,41,,2,93,20,,227
6100,Merkel,251,49,,5,50,10,,300
6101,antisemitisme,67,13,,1,67,13,,80
6102,højreradikalisme,67,13,,1,67,13,,80
6103,offerundersøgelser,67,13,,1,67,13,,80
6104,https://t.co/uoztC7oZhq,67,13,,1,67,13,,80
6105,Time,1,0,,1,1,0,,1
6106,udgave,4,0,,2,2,0,,4
6107,syndig,31,8,,1,31,8,,39
6108,Centralisering,93,24,,3,31,8,,117
6109,respons,151,19,,2,76,10,,170
6110,lokalformand,89,9,,1,89,9,,98
6111,original,134,16,,6,22,3,,150
6112,ikke-trivielt,89,9,,1,89,9,,98
6113,glædelig,108,22,,3,36,7,,130
6114,kontekst,0,0,,1,0,0,,0
6115,hyldest,16,3,,1,16,3,,19
6116,middelklasse,132,13,,3,44,4,,145
6117,skepsis,16,3,,1,16,3,,19
6118,efterkommer,65,11,,3,22,4,,76
6119,Stormellemøsten,167,25,,2,84,12,,192
6120,https://t.co/hAoXhgjmdX,21,0,,1,21,0,,21
6121,ydmyge,23,0,,1,23,0,,23
6122,fodslag,28,0,,2,14,0,,28
6123,café-pengene,3,3,,1,3,3,,6
6124,Margaret,26,10,,2,13,5,,36
6125,Thatcher,26,10,,2,13,5,,36
6126,Downing,6,0,,1,6,0,,6
6127,Street,6,0,,1,6,0,,6
6128,niqab,3,0,,1,3,0,,3
6129,inhabilitet,0,0,,1,0,0,,0
6130,Tina,1,1,,2,0,0,,2
6131,Fussels,0,0,,1,0,0,,0
6132,Bjerrums,0,0,,1,0,0,,0
6133,grundlovsstridig,691,18,,2,346,9,,709
6134,instruks,427,8,,1,427,8,,435
6135,LA's,11,19,,3,4,6,,30
6136,kernekraft,1,0,,1,1,0,,1
6137,blæse,48,1,,2,24,0,,49
6138,biomasse,1,0,,2,0,0,,1
6139,egenkapital,0,0,,2,0,0,,0
6140,skam,686,34,,4,172,8,,720
6141,rygte,4,0,,1,4,0,,4
6142,Radikalisering,3,0,,1,3,0,,3
6143,https://t.co/3JgDreihtV,3,0,,1,3,0,,3
6144,SFU,3,0,,2,2,0,,3
6145,indkomstskat,0,0,,2,0,0,,0
6146,tilføjelse,9,1,,1,9,1,,10
6147,statslån,9,1,,1,9,1,,10
6148,favorabel,9,1,,1,9,1,,10
6149,forbavse,3,0,,1,3,0,,3
6150,udkomme,3,0,,1,3,0,,3
6151,vuls15,13,15,,1,13,15,,28
6152,forhånd,36,18,,2,18,9,,54
6153,festtale,13,15,,1,13,15,,28
6154,glimre,17,2,,2,8,1,,19
6155,tillægsforsikring,25,3,,2,12,2,,28
6156,dagpengesystem,16,2,,1,16,2,,18
6157,solid,63,2,,3,21,1,,65
6158,fremragende,48,4,,4,12,1,,52
6159,retoriker,1,0,,1,1,0,,1
6160,victim,1,0,,1,1,0,,1
6161,blaming,1,0,,1,1,0,,1
6162,insinuation,3,0,,2,2,0,,3
6163,Forskellene,3,2,,1,3,2,,5
6164,marginal,3,2,,1,3,2,,5
6165,https://t.co/Dj7aJoAsdx,3,2,,1,3,2,,5
6166,klippe,94,15,,3,31,5,,109
6167,Detektor,148,8,,6,25,1,,156
6168,finanslovsdebat,7,0,,1,7,0,,7
6169,særinteresse,7,0,,1,7,0,,7
6170,julebord,7,0,,1,7,0,,7
6171,https://t.co/Nd28lCzffA,7,0,,1,7,0,,7
6172,superinteressant,28,6,,1,28,6,,34
6173,bære,2,1,,2,1,0,,3
6174,topfolk,41,6,,1,41,6,,47
6175,gennemskue,45,6,,3,15,2,,51
6176,samfundssind,192,28,,2,96,14,,220
6177,13-skalaen,26,6,,1,26,6,,32
6178,7-trinsskalaen,26,6,,1,26,6,,32
6179,https://t.co/xJdTbYZpaQ,26,6,,1,26,6,,32
6180,19.,25,1,,1,25,1,,26
6181,Fuld,124,26,,5,25,5,,150
6182,https://t.co/yoGaSKuLOZ,25,1,,1,25,1,,26
6183,lort,1,0,,3,0,0,,1
6184,opvasker,0,0,,1,0,0,,0
6185,avisuddeler,0,0,,1,0,0,,0
6186,fejedreng,0,0,,1,0,0,,0
6187,kioskarbejder,0,0,,1,0,0,,0
6188,Middle,6,0,,1,6,0,,6
6189,Jutland,6,0,,1,6,0,,6
6190,Gymnasium,45,5,,2,22,2,,50
6191,dannelse,123,12,,5,25,2,,135
6192,antidemokratisk,32,5,,1,32,5,,37
6193,pøbelvælde,32,5,,1,32,5,,37
6194,Sidste,13,3,,1,13,3,,16
6195,gåtur,13,3,,1,13,3,,16
6196,hund,14,3,,2,7,2,,17
6197,Damhusengen,13,3,,1,13,3,,16
6198,https://t.co/0qdKQavE6i,13,3,,1,13,3,,16
6199,Staten,8,0,,1,8,0,,8
6200,vækstinitiativer,10,1,,1,10,1,,11
6201,fas,10,1,,1,10,1,,11
6202,00’erne,3,0,,1,3,0,,3
6203,90’erne,17,0,,2,8,0,,17
6204,80’erne,3,0,,1,3,0,,3
6205,70’erne,3,0,,1,3,0,,3
6206,50-milliarder-grænsen,78,15,,1,78,15,,93
6207,omdømme,163,26,,2,82,13,,189
6208,https://t.co/wgmXJsacAz,78,15,,1,78,15,,93
6209,Ulighed,17,4,,2,8,2,,21
6210,position,148,39,,4,37,10,,187
6211,bullshit,1,0,,1,1,0,,1
6212,Oxfam,1,0,,1,1,0,,1
6213,IBIS-specialitet,1,0,,1,1,0,,1
6214,Politik,59,3,,5,12,1,,62
6215,ICU-point,6,0,,1,6,0,,6
6216,https://t.co/9MBeOiHs6P,6,0,,1,6,0,,6
6217,turban,21,4,,1,21,4,,25
6218,https://t.co/sCMBo4hgqW,21,4,,1,21,4,,25
6219,Skærbæk,28,0,,1,28,0,,28
6220,Ribe,28,0,,1,28,0,,28
6221,slendrian,28,0,,1,28,0,,28
6222,rumlov,18,13,,2,9,6,,31
6223,univers,15,13,,1,15,13,,28
6224,antistof,30,26,,2,15,13,,56
6225,bureaukrati,193,44,,3,64,15,,237
6226,KU'erne,23,5,,1,23,5,,28
6227,fredsløsning,23,5,,1,23,5,,28
6228,Guldberghus,23,5,,1,23,5,,28
6229,lejlighed,54,7,,3,18,2,,61
6230,kulr15,23,5,,1,23,5,,28
6231,fremmest,237,22,,5,47,4,,259
6232,samfundsinstitutioner,2,0,,1,2,0,,2
6233,Leksikon,2,0,,1,2,0,,2
6234,Artikel,2,0,,1,2,0,,2
6235,løftebrudsregering,11,7,,2,6,4,,18
6236,DRdinstemme,35,27,,8,4,3,,62
6237,Simon,0,0,,1,0,0,,0
6238,Emil,0,0,,1,0,0,,0
6239,https://t.co/sDBkJeZtox,2,1,,1,2,1,,3
6240,Familier,62,7,,1,62,7,,69
6241,fodbold,62,7,,1,62,7,,69
6242,dagpengeforhøjelse,9,1,,1,9,1,,10
6243,begave,6,4,,2,3,2,,10
6244,voks,30,15,,4,8,4,,45
6245,tysse,6,15,,1,6,15,,21
6246,selskabsskat,665,56,,6,111,9,,721
6247,EP2019,46,3,,1,46,3,,49
6248,statschef,4,0,,1,4,0,,4
6249,Nord-,4,0,,1,4,0,,4
6250,https://t.co/hftVQL3DIY,4,0,,1,4,0,,4
6251,Arnes,280,8,,1,280,8,,288
6252,oprigtig,382,8,,4,96,2,,390
6253,juridisk,352,18,,3,117,6,,370
6254,kønsskifte,373,25,,3,124,8,,398
6255,5-årige,280,8,,1,280,8,,288
6256,harmonisering,74,4,,2,37,2,,78
6257,vækstkritikere,13,4,,1,13,4,,17
6258,https://t.co/eYhT8OpVW1,13,4,,1,13,4,,17
6259,fundamental,66,12,,3,22,4,,78
6260,anderledes,93,7,,4,23,2,,100
6261,Poulsen,61,13,,3,20,4,,74
6262,decidere,879,53,,4,220,13,,932
6263,skamløs,670,34,,1,670,34,,704
6264,oplevelsesindustrien,670,34,,1,670,34,,704
6265,dagpengemodtager,670,34,,1,670,34,,704
6266,gåde,724,44,,2,362,22,,768
6267,https://t.co/S2PZ5HIXKp,670,34,,1,670,34,,704
6268,rekord,100,14,,2,50,7,,114
6269,afsløring,70,1,,1,70,1,,71
6270,https://t.co/5unjwJACnJ,70,1,,1,70,1,,71
6271,troværdig,0,0,,1,0,0,,0
6272,korps,0,0,,1,0,0,,0
6273,anmeldelse,16,1,,2,8,0,,17
6274,fange,0,0,,1,0,0,,0
6275,totalskadet,17,4,,1,17,4,,21
6276,https://t.co/UaRElsF8sY,17,4,,1,17,4,,21
6277,systemfejl,4,0,,2,2,0,,4
6278,eftervederlag,2,0,,1,2,0,,2
6279,optjene,2,0,,1,2,0,,2
6280,studie,2,0,,1,2,0,,2
6281,Klimadebatten,52,10,,1,52,10,,62
6282,populistisk,52,10,,1,52,10,,62
6283,blik,166,40,,3,55,13,,206
6284,William,52,10,,1,52,10,,62
6285,Nordhaus,52,10,,1,52,10,,62
6286,Greta,275,24,,3,92,8,,299
6287,Thunberg,264,24,,2,132,12,,288
6288,https://t.co/t38ioKPru1,52,10,,1,52,10,,62
6289,smileys,29,2,,1,29,2,,31
6290,kommunikere,43,3,,2,22,2,,46
6291,Vestager,14,6,,1,14,6,,20
6292,Anti-elitens,14,6,,1,14,6,,20
6293,https://t.co/yZChiNZWnr,14,6,,1,14,6,,20
6294,https://t.co/C8YxXX26TH,6,0,,1,6,0,,6
6295,valgvideo,12,3,,2,6,2,,15
6296,https://t.co/b6r5UdWXQ2,2,1,,1,2,1,,3
6297,LiberalAlliance,7,1,,3,2,0,,8
6298,dum,4,0,,2,2,0,,4
6299,lade,135,19,,2,68,10,,154
6300,åndssvag,1,0,,1,1,0,,1
6301,karikatur,1,0,,1,1,0,,1
6302,JBO,1,0,,1,1,0,,1
6303,fornuftig,36,0,,5,7,0,,36
6304,udledning,177,23,,5,35,5,,200
6305,eksemplet,0,0,,1,0,0,,0
6306,læse,5,0,,2,2,0,,5
6307,indenad,1,0,,1,1,0,,1
6308,ordensmagt,15,1,,1,15,1,,16
6309,https://t.co/4SkKA6Lfts,15,1,,1,15,1,,16
6310,Produktionsskolerne,1,0,,1,1,0,,1
6311,Hermann-udvalgets,1,0,,1,1,0,,1
6312,uddannelsessystem,100,8,,2,50,4,,108
6313,rulle,21,1,,2,10,0,,22
6314,2015-niveau,2,0,,1,2,0,,2
6315,POV's,8,1,,1,8,1,,9
6316,spalte,8,1,,1,8,1,,9
6317,https://t.co/l64XMOKLWx,8,1,,1,8,1,,9
6318,STM,401,33,,1,401,33,,434
6319,Grunden,418,34,,2,209,17,,452
6320,What,478,43,,5,96,9,,521
6321,Sundhedsvæsenet,401,33,,1,401,33,,434
6322,rettelse,3,0,,1,3,0,,3
6323,tidsbesparelse,3,0,,1,3,0,,3
6324,akutpakke,0,3,,1,0,3,,3
6325,lappeløsning,9,3,,2,4,2,,12
6326,https://t.co/Q66u27cSV1,0,3,,1,0,3,,3
6327,apparat,4,0,,1,4,0,,4
6328,Peg,64,0,,2,32,0,,64
6329,ejendomsret,32,0,,1,32,0,,32
6330,socialistisk,63,1,,3,21,0,,64
6331,Suck,48,3,,1,48,3,,51
6332,meicester,3,0,,1,3,0,,3
6333,idiot,34,4,,3,11,1,,38
6334,partifælle,10,3,,2,5,2,,13
6335,Høiby,9,2,,1,9,2,,11
6336,https://t.co/FFOYfCJdbK,9,2,,1,9,2,,11
6337,regelbrud,4,1,,2,2,0,,5
6338,nærværende,2,0,,1,2,0,,2
6339,lovovertrædelse,2,0,,1,2,0,,2
6340,Fædrelandet,59,3,,1,59,3,,62
6341,https://t.co/g1AnAKivcx,59,3,,1,59,3,,62
6342,risikovillig,31,0,,1,31,0,,31
6343,kapital,31,0,,1,31,0,,31
6344,kompensationsgrad,0,0,,1,0,0,,0
6345,fjende,47,8,,4,12,2,,55
6346,NedMedSkatten,4,0,,1,4,0,,4
6347,Bud,2,3,,1,2,3,,5
6348,https://t.co/EkxFST15uw,2,3,,1,2,3,,5
6349,NuLoverDeIgen,9,5,,1,9,5,,14
6350,forælde,7,0,,1,7,0,,7
6351,OECD's,15,5,,1,15,5,,20
6352,ulighedsdebatten,15,5,,1,15,5,,20
6353,træls,15,5,,2,8,2,,20
6354,https://t.co/bFY7We8R4e,15,5,,1,15,5,,20
6355,http://t.co/PTr5dyts7U,6,7,,1,6,7,,13
6356,forargelse,10,1,,1,10,1,,11
6357,socioøkonomisk,94,5,,1,94,5,,99
6358,baggrundsvariable,94,5,,1,94,5,,99
6359,https://t.co/1epTlYCmZs,94,5,,1,94,5,,99
6360,subjektiv,9,0,,3,3,0,,9
6361,problematisk,72,13,,3,24,4,,85
6362,underminere,14,2,,1,14,2,,16
6363,Kaare,18,3,,4,4,1,,21
6364,plette,14,2,,1,14,2,,16
6365,risikovurdering,25,7,,3,8,2,,32
6366,Løhde,14,2,,1,14,2,,16
6367,velhavende,12,0,,4,3,0,,12
6368,stagnation,9,1,,2,4,0,,10
6369,førhen,3,0,,1,3,0,,3
6370,https://t.co/Ub5vZTE3IH,3,0,,1,3,0,,3
6371,Skam,8,1,,1,8,1,,9
6372,Egon,8,1,,1,8,1,,9
6373,Fræhr,8,1,,1,8,1,,9
6374,https://t.co/u7oram30T1,8,1,,1,8,1,,9
6375,Kattegat-forbindelse,6,0,,1,6,0,,6
6376,millionærskat,0,0,,1,0,0,,0
6377,Sammenligning,1,0,,1,1,0,,1
6378,Politikken,6,0,,2,3,0,,6
6379,skattekrone,275,35,,3,92,12,,310
6380,foretage,11,3,,1,11,3,,14
6381,https://t.co/1e4DRIAtHF,11,3,,1,11,3,,14
6382,Cool,0,0,,1,0,0,,0
6383,reglement,32,1,,1,32,1,,33
6384,Bønsing,32,1,,1,32,1,,33
6385,Tesfaye,32,1,,1,32,1,,33
6386,https://t.co/KuYPJaMtRV,32,1,,1,32,1,,33
6387,budgetaftale,1,0,,1,1,0,,1
6388,genopretningsfonden,1,0,,1,1,0,,1
6389,Euro-landene,1,0,,1,1,0,,1
6390,minusvækst,1,5,,4,0,1,,6
6391,Hykleri,4,3,,2,2,2,,7
6392,uambitiøse,0,1,,1,0,1,,1
6393,nulvækst,0,1,,1,0,1,,1
6394,Villum,0,0,,1,0,0,,0
6395,spørgsmålstegn,0,0,,1,0,0,,0
6396,Hovsa,0,0,,1,0,0,,0
6397,Dahlin,152,1,,2,76,0,,153
6398,Kurt,0,0,,1,0,0,,0
6399,Nielsen,43,9,,2,22,4,,52
6400,træne,0,0,,1,0,0,,0
6401,Laudrup'erne,0,0,,1,0,0,,0
6402,kronisk,35,8,,2,18,4,,43
6403,invalidere,0,0,,1,0,0,,0
6404,Klynk,0,0,,1,0,0,,0
6405,selvmedlidenhed,0,0,,1,0,0,,0
6406,førnævnt,0,0,,1,0,0,,0
6407,vejkapacitet,5,0,,1,5,0,,5
6408,energikilde,25,4,,2,12,2,,29
6409,forkastelig,2,0,,1,2,0,,2
6410,Fagbevægelsen,11,0,,2,6,0,,11
6411,medlemsdemokrati,0,0,,1,0,0,,0
6412,NÆSTE,46,0,,1,46,0,,46
6413,GANG,46,0,,1,46,0,,46
6414,Anthony,212,10,,1,212,10,,222
6415,Fauci,212,10,,1,212,10,,222
6416,https://t.co/m6LmVoJAR8,26,4,,1,26,4,,30
6417,Weekendavisen,115,4,,2,58,2,,119
6418,Mel,16,1,,1,16,1,,17
6419,Gibson,16,1,,1,16,1,,17
6420,Women,16,1,,1,16,1,,17
6421,Want,16,1,,1,16,1,,17
6422,https://t.co/UfdNUxtxst,16,1,,1,16,1,,17
6423,Næh,15,3,,2,8,2,,18
6424,patientrettighed,173,3,,2,86,2,,176
6425,henrette,1,0,,1,1,0,,1
6426,hug,6,1,,2,3,0,,7
6427,kant,105,12,,6,18,2,,117
6428,protese,1,0,,1,1,0,,1
6429,omvæltning,7,0,,1,7,0,,7
6430,Finansiering,7,0,,1,7,0,,7
6431,2030-plan,7,0,,1,7,0,,7
6432,afsavn,119,12,,3,40,4,,131
6433,kernevælger,20,7,,1,20,7,,27
6434,pengepung,20,7,,1,20,7,,27
6435,førsteprioritet,20,7,,1,20,7,,27
6436,https://t.co/oIHZ8s6ELP,20,7,,1,20,7,,27
6437,unde,0,0,,1,0,0,,0
6438,komfort,0,1,,1,0,1,,1
6439,usandhed,0,1,,1,0,1,,1
6440,nutid,39,2,,2,20,1,,41
6441,68'ernes,4,1,,1,4,1,,5
6442,kollektivistisk,4,1,,1,4,1,,5
6443,ungdomsoprør,4,1,,1,4,1,,5
6444,Sydjyllands,9,3,,1,9,3,,12
6445,Storkreds,15,7,,2,8,4,,22
6446,behagelig,27,3,,2,14,2,,30
6447,Bedste,17,0,,2,8,0,,17
6448,lønskala,0,0,,1,0,0,,0
6449,hvide,762,52,,4,190,13,,814
6450,symbol,757,15,,2,378,8,,772
6451,https://t.co/KcE3uZrVuo,69,1,,1,69,1,,70
6452,VUer,3,2,,1,3,2,,5
6453,boligjob,3,2,,1,3,2,,5
6454,Sofie,131,13,,2,66,6,,144
6455,Lippert,88,4,,1,88,4,,92
6456,statstilskud,88,4,,1,88,4,,92
6457,akademiker,121,10,,4,30,2,,131
6458,livsindkomst,116,6,,2,58,3,,122
6459,klassepolitik,88,4,,1,88,4,,92
6460,https://t.co/xJYfOOrtS0,88,4,,1,88,4,,92
6461,NNF,1,0,,1,1,0,,1
6462,dobbelt,1,0,,2,0,0,,1
6463,akkord,1,0,,1,1,0,,1
6464,betydning,28,8,,4,7,2,,36
6465,V-regering,105,5,,2,52,2,,110
6466,fungerendeministerliv,105,5,,1,105,5,,110
6467,https://t.co/XKUjJ0nD8n,105,5,,1,105,5,,110
6468,regelændring,0,0,,1,0,0,,0
6469,trossag,0,0,,1,0,0,,0
6470,breezere,75,4,,1,75,4,,79
6471,frembrud,75,4,,1,75,4,,79
6472,lyse,75,4,,1,75,4,,79
6473,https://t.co/BiV7wUT6HI,75,4,,1,75,4,,79
6474,Selskabsskatten,3,4,,1,3,4,,7
6475,produktivitetskommission,3,4,,1,3,4,,7
6476,blokere,5,0,,1,5,0,,5
6477,tilsvinerne,5,0,,1,5,0,,5
6478,Amalie,8,0,,1,8,0,,8
6479,https://t.co/IpTKvmaNWD,167,10,,1,167,10,,177
6480,Auken,9,0,,1,9,0,,9
6481,Storm,9,0,,1,9,0,,9
6482,Rasmussen-udvalgets,9,0,,1,9,0,,9
6483,udlæg,6,1,,1,6,1,,7
6484,endelig,13,1,,2,6,0,,14
6485,Flyver,2,0,,1,2,0,,2
6486,Uforbederlige,29,4,,1,29,4,,33
6487,indvending,1,0,,1,1,0,,1
6488,utiltalende,1,0,,1,1,0,,1
6489,scenarie,1,0,,1,1,0,,1
6490,tiltag,12,3,,8,2,0,,15
6491,Understøtter,1,0,,1,1,0,,1
6492,fundamentalisme,1,0,,1,1,0,,1
6493,Dele,18,0,,2,9,0,,18
6494,Gartnere,9,0,,1,9,0,,9
6495,kirkepassere,9,0,,1,9,0,,9
6496,kategori,9,0,,1,9,0,,9
6497,sagsbehandlerkorpset,9,0,,1,9,0,,9
6498,jobcentrene,25,7,,2,12,4,,32
6499,Dommere,9,0,,1,9,0,,9
6500,retssystem,9,0,,1,9,0,,9
6501,køre,59,7,,2,30,4,,66
6502,ligestillingsproblem,7,4,,1,7,4,,11
6503,Jensens,55,3,,3,18,1,,58
6504,afgang,12,0,,2,6,0,,12
6505,regime,208,16,,3,69,5,,224
6506,oprørsk,181,11,,1,181,11,,192
6507,borge,300,11,,3,100,4,,311
6508,https://t.co/ShiKX6Wv8V,181,11,,1,181,11,,192
6509,https://t.co/9MMn859tUg,2,2,,1,2,2,,4
6510,præstation,40,2,,2,20,1,,42
6511,merforbrug,4,0,,1,4,0,,4
6512,Mordhorst,41,2,,1,41,2,,43
6513,forske,41,2,,1,41,2,,43
6514,omsætningsrekord,41,2,,1,41,2,,43
6515,https://t.co/L57PFboEwa,41,2,,1,41,2,,43
6516,https://t.co/lCMvTjxttr,7,0,,1,7,0,,7
6517,https://t.co/Mn8AVCW8tZ,1,1,,1,1,1,,2
6518,Politikernes,10,2,,2,5,1,,12
6519,juæepynt,0,0,,1,0,0,,0
6520,http://t.co/m4I2ONHaEF,0,0,,1,0,0,,0
6521,Lønmodtagerne,2,2,,1,2,2,,4
6522,milliardær,2,2,,1,2,2,,4
6523,overdiagnosticering,0,0,,1,0,0,,0
6524,øvrig,92,6,,2,46,3,,98
6525,overdiagnosticeringen,0,0,,1,0,0,,0
6526,grundinfantilt,33,3,,1,33,3,,36
6527,adbadbadbadbad,33,3,,1,33,3,,36
6528,sekund,329,36,,6,55,6,,365
6529,tvangsfjerne,5,4,,1,5,4,,9
6530,http://t.co/sSY9LjPvDq,5,4,,1,5,4,,9
6531,retningsparti,0,0,,1,0,0,,0
6532,endemålsparti,0,0,,1,0,0,,0
6533,økonom,307,14,,3,102,5,,321
6534,fact,283,28,,2,142,14,,311
6535,LO-arbejder,277,22,,1,277,22,,299
6536,gini-koefficient,277,22,,1,277,22,,299
6537,diabetiker,560,17,,1,560,17,,577
6538,grundlovsbrud,560,17,,1,560,17,,577
6539,tilladelse,66,6,,2,33,3,,72
6540,mobning,2,0,,2,1,0,,2
6541,religiøs,3,0,,2,2,0,,3
6542,overbevisning,2,0,,2,1,0,,2
6543,foreningsmæssige,1,0,,1,1,0,,1
6544,buffer,8,1,,1,8,1,,9
6545,samarit,0,0,,1,0,0,,0
6546,eksplicit,3,0,,1,3,0,,3
6547,Skarpvinklet,3,0,,1,3,0,,3
6548,Bakterier,29,0,,1,29,0,,29
6549,hade,29,0,,1,29,0,,29
6550,sarkasme,29,0,,1,29,0,,29
6551,Folkebevægelsen,35,1,,1,35,1,,36
6552,flyrejse,35,1,,1,35,1,,36
6553,70er-socialismens,35,1,,1,35,1,,36
6554,metodespørgsmål,18,6,,1,18,6,,24
6555,https://t.co/awOsQ0cuVT,18,6,,1,18,6,,24
6556,forsørgelse,157,29,,6,26,5,,186
6557,arbejdsindsats,0,0,,1,0,0,,0
6558,Amanda,7,2,,1,7,2,,9
6559,LAU,8,2,,1,8,2,,10
6560,Nøgleordet,34,0,,1,34,0,,34
6561,https://t.co/sKlGNqrNE9,34,0,,1,34,0,,34
6562,kollektiv,204,14,,7,29,2,,218
6563,uansvarlighed,158,10,,1,158,10,,168
6564,https://t.co/5KA7qRGoTX,158,10,,1,158,10,,168
6565,samfundsbidrag,567,34,,4,142,8,,601
6566,skattebetaling,1,0,,1,1,0,,1
6567,RUC,21,2,,1,21,2,,23
6568,https://t.co/X4aRP75t3O,21,2,,1,21,2,,23
6569,Forræderi,56,9,,1,56,9,,65
6570,institution,231,25,,6,38,4,,256
6571,facit,56,9,,1,56,9,,65
6572,https://t.co/DTygFijvz4,56,9,,1,56,9,,65
6573,børnebidrag,3,0,,1,3,0,,3
6574,børneydelsen,3,0,,1,3,0,,3
6575,unødig,41,2,,2,20,1,,43
6576,overførsel,40,2,,1,40,2,,42
6577,uskik,40,2,,1,40,2,,42
6578,almindelighed,40,2,,1,40,2,,42
6579,https://t.co/dRU5WeUSki,40,2,,1,40,2,,42
6580,sladder,2,0,,1,2,0,,2
6581,ægte,7,4,,3,2,1,,11
6582,http://t.co/pUVKXQE4,2,3,,1,2,3,,5
6583,Kåre,79,5,,1,79,5,,84
6584,café,79,5,,1,79,5,,84
6585,SSI,79,5,,2,40,2,,84
6586,mavefornemmelser,79,5,,1,79,5,,84
6587,https://t.co/3r9cCtpHZ6,79,5,,1,79,5,,84
6588,https://t.co/5CwolBUU28,79,5,,1,79,5,,84
6589,diskonto,7,0,,1,7,0,,7
6590,Flensborg,7,0,,1,7,0,,7
6591,Mars,7,0,,1,7,0,,7
6592,ascendanten,7,0,,1,7,0,,7
6593,DYB,295,13,,1,295,13,,308
6594,vælgerforagtende,295,13,,1,295,13,,308
6595,løgnagtighed,295,13,,1,295,13,,308
6596,Størstedelen,6,6,,1,6,6,,12
6597,taler,24,11,,2,12,6,,35
6598,fælledpark,6,6,,1,6,6,,12
6599,Ministerium,14,0,,1,14,0,,14
6600,klimavenlige,2,0,,2,1,0,,2
6601,religion,21,4,,5,4,1,,25
6602,boligejer,27,6,,3,9,2,,33
6603,John,2,0,,2,1,0,,2
6604,Skovrup,0,0,,1,0,0,,0
6605,Bække,0,0,,1,0,0,,0
6606,Dahlmobilen,0,0,,1,0,0,,0
6607,provenu,2,0,,2,1,0,,2
6608,uærlig,1,0,,1,1,0,,1
6609,ild,13,2,,1,13,2,,15
6610,registreringsafgift,13,2,,1,13,2,,15
6611,forbrændingsmotor,13,2,,1,13,2,,15
6612,skive,26,3,,2,13,2,,29
6613,intellektuel,209,10,,4,52,2,,219
6614,spøg,2,0,,1,2,0,,2
6615,Weekendavisens,2,0,,1,2,0,,2
6616,Metoden,2,0,,1,2,0,,2
6617,afgrænsning,2,0,,1,2,0,,2
6618,coronavirussen,46,10,,1,46,10,,56
6619,Berlingskes,99,14,,2,50,7,,113
6620,redaktør,46,10,,1,46,10,,56
6621,EU-penge,46,10,,1,46,10,,56
6622,socialdemokrati,33,1,,3,11,0,,34
6623,skatteindtægt,21,0,,1,21,0,,21
6624,Gollum,21,0,,1,21,0,,21
6625,https://t.co/3JBkFaDt4u,21,0,,1,21,0,,21
6626,.@radikalungdom,1,2,,1,1,2,,3
6627,FB-kampagner,1,2,,1,1,2,,3
6628,hitte,1,2,,1,1,2,,3
6629,virusorm,1,2,,1,1,2,,3
6630,https://t.co/4sv7qEfMiW,1,2,,1,1,2,,3
6631,https://t.co/ryecTxsImx,1,2,,1,1,2,,3
6632,lyseblå,428,10,,1,428,10,,438
6633,FN-hjelm,428,10,,1,428,10,,438
6634,https://t.co/8hXcNoRZru,428,10,,1,428,10,,438
6635,ringeagt,100,0,,1,100,0,,100
6636,ideologi,396,51,,3,132,17,,447
6637,Statskassen,206,22,,1,206,22,,228
6638,nulevende,4,0,,1,4,0,,4
6639,slaveejer,4,0,,1,4,0,,4
6640,Kammeradvokatens,17,2,,1,17,2,,19
6641,Statens,74,18,,3,25,6,,92
6642,Serum,47,8,,2,24,4,,55
6643,Institut,47,8,,2,24,4,,55
6644,makværk,17,2,,1,17,2,,19
6645,hensigt,29,3,,2,14,2,,32
6646,Forklar,99,1,,2,50,0,,100
6647,Minimumsnormeringer,7,0,,1,7,0,,7
6648,historieløs,99,16,,3,33,5,,115
6649,https://t.co/Ny7bOASpGL,55,3,,1,55,3,,58
6650,Varmt,2,1,,1,2,1,,3
6651,Hamas-raketter,28,5,,1,28,5,,33
6652,værn,740,24,,2,370,12,,764
6653,Samtale,38,4,,1,38,4,,42
6654,Jes,38,4,,1,38,4,,42
6655,Stein,38,4,,1,38,4,,42
6656,konstruktion,74,19,,2,37,10,,93
6657,uvirkelighed,38,4,,1,38,4,,42
6658,https://t.co/B6RxYuDXFL,38,4,,1,38,4,,42
6659,demografisk,12,0,,1,12,0,,12
6660,Post,308,17,,1,308,17,,325
6661,2020’erne,446,27,,3,149,9,,473
6662,1920’erne,308,17,,1,308,17,,325
6663,chok,142,8,,2,71,4,,150
6664,https://t.co/LCEfpcC7aZ,71,4,,1,71,4,,75
6665,oplæse,20,4,,1,20,4,,24
6666,valgplatform,20,4,,1,20,4,,24
6667,https://t.co/SMikDazfsC,20,4,,1,20,4,,24
6668,Artiklen,44,8,,3,15,3,,52
6669,nyuddannet,5,0,,1,5,0,,5
6670,ansøgerfelt,184,16,,1,184,16,,200
6671,uformel,200,26,,2,100,13,,226
6672,https://t.co/CfZVnk875X,184,16,,1,184,16,,200
6673,fanden,477,28,,2,238,14,,505
6674,clairvoyance,388,27,,1,388,27,,415
6675,https://t.co/6f2Jq5RESk,388,27,,1,388,27,,415
6676,Vold,0,0,,1,0,0,,0
6677,provokation,0,0,,1,0,0,,0
6678,https://t.co/Z5JjmsfzFH,12,2,,1,12,2,,14
6679,Præstationssamfundet,179,13,,1,179,13,,192
6680,omløb,179,13,,1,179,13,,192
6681,Svært,182,16,,3,61,5,,198
6682,kynisk,179,13,,1,179,13,,192
6683,Clement,11,1,,1,11,1,,12
6684,https://t.co/SOKVLtVDRV,11,1,,1,11,1,,12
6685,disciplin,12,0,,2,6,0,,12
6686,humoristisk,173,12,,3,58,4,,185
6687,sans,839,60,,4,210,15,,899
6688,https://t.co/OQHycXgxAt,167,12,,1,167,12,,179
6689,massegrav,29,2,,1,29,2,,31
6690,influenzaepidemi,29,2,,1,29,2,,31
6691,confirmation,29,2,,1,29,2,,31
6692,bias,29,2,,1,29,2,,31
6693,https://t.co/mJvoDAy9I5,29,2,,1,29,2,,31
6694,Dragsted,149,4,,1,149,4,,153
6695,populist,59,12,,3,20,4,,71
6696,studehandel,1,0,,1,1,0,,1
6697,stand,1,0,,1,1,0,,1
6698,https://t.co/LkC9ulXQsj,5,0,,1,5,0,,5
6699,hud,46,4,,1,46,4,,50
6700,https://t.co/l7AhVispmC,46,4,,1,46,4,,50
6701,Yahya,183,14,,4,46,4,,197
6702,Hassan,16,1,,2,8,0,,17
6703,ytring,10,2,,3,3,1,,12
6704,PET-vagter,3,1,,1,3,1,,4
6705,yahyahassan,3,1,,1,3,1,,4
6706,privathospital,0,1,,1,0,1,,1
6707,kontra,0,1,,1,0,1,,1
6708,Milos,1,0,,1,1,0,,1
6709,Zeman,1,0,,1,1,0,,1
6710,UNGA-tale,1,0,,1,1,0,,1
6711,Fukuyama,1,0,,1,1,0,,1
6712,Huntington,1,0,,1,1,0,,1
6713,UNGA72,1,0,,1,1,0,,1
6714,bevilge,40,4,,1,40,4,,44
6715,videregående,40,4,,2,20,2,,44
6716,supplering,40,4,,1,40,4,,44
6717,https://t.co/gd0xl3FBHC,40,4,,1,40,4,,44
6718,tankeeksperiment,0,0,,1,0,0,,0
6719,pigesur,0,1,,1,0,1,,1
6720,https://t.co/ovHg6Ur8f1,0,1,,1,0,1,,1
6721,Clinton-kritisk,15,2,,1,15,2,,17
6722,180Grader,1,0,,2,0,0,,1
6723,redaktion,97,7,,4,24,2,,104
6724,slette,1,0,,1,1,0,,1
6725,klage,7,1,,3,2,0,,8
6726,Annes,75,2,,1,75,2,,77
6727,levetid,105,12,,2,52,6,,117
6728,Anne,75,2,,1,75,2,,77
6729,https://t.co/rPlZX5On4W,75,2,,1,75,2,,77
6730,gaderøverier,1107,92,,1,1107,92,,1199
6731,videoovervågning,1107,92,,1,1107,92,,1199
6732,Politi,1116,92,,2,558,46,,1208
6733,kameraovervågning,1107,92,,1,1107,92,,1199
6734,strøg,1107,92,,1,1107,92,,1199
6735,masseovervågning,1107,92,,1,1107,92,,1199
6736,perfekthedskulturen,2,0,,1,2,0,,2
6737,https://t.co/2rpGkm2OTy,2,0,,1,2,0,,2
6738,indkomstgruppe,263,14,,1,263,14,,277
6739,afgiftspolitik,263,14,,1,263,14,,277
6740,komisk,263,14,,2,132,7,,277
6741,https://t.co/0fE0cMB7cR,263,14,,1,263,14,,277
6742,sml.,1,0,,1,1,0,,1
6743,udg,1,0,,1,1,0,,1
6744,Stærk,48,17,,6,8,3,,65
6745,Tom,24,2,,1,24,2,,26
6746,Anbefales,24,2,,1,24,2,,26
6747,https://t.co/jwUhwNSIoP,24,2,,1,24,2,,26
6748,berettige,5,0,,1,5,0,,5
6749,tast,12,0,,1,12,0,,12
6750,Theresa,61,5,,2,30,2,,66
6751,May,116,12,,4,29,3,,128
6752,Ishøj,3,0,,1,3,0,,3
6753,Sovjetunionen,3,0,,1,3,0,,3
6754,runge,6,3,,1,6,3,,9
6755,kommunesammenlægning,6,3,,1,6,3,,9
6756,Struer,37,15,,3,12,5,,52
6757,Holstebro,7,5,,2,4,2,,12
6758,Folket,6,3,,1,6,3,,9
6759,3dec,6,3,,1,6,3,,9
6760,fuckingløbehjul,47,3,,1,47,3,,50
6761,Vesterport,47,3,,1,47,3,,50
6762,https://t.co/mJzIaSEYla,47,3,,1,47,3,,50
6763,uforudsigeligehed,4,1,,1,4,1,,5
6764,kreativitet,4,1,,1,4,1,,5
6765,beundringsværdig,4,1,,1,4,1,,5
6766,Karen,93,5,,3,31,2,,98
6767,Blixen,78,4,,1,78,4,,82
6768,disintegration,3,4,,1,3,4,,7
6769,marsbo,20,0,,2,10,0,,20
6770,lytning,10,0,,1,10,0,,10
6771,orwellsk,122,6,,1,122,6,,128
6772,newspeak,122,6,,1,122,6,,128
6773,særskat,122,6,,1,122,6,,128
6774,Katrine,187,14,,1,187,14,,201
6775,uddannelsesdebatten,187,14,,1,187,14,,201
6776,forrykt,187,14,,1,187,14,,201
6777,uhørt,187,14,,1,187,14,,201
6778,tavs,214,17,,2,107,8,,231
6779,https://t.co/plJa1Lc1UR,187,14,,1,187,14,,201
6780,angst,1,0,,1,1,0,,1
6781,Relevant,1,0,,1,1,0,,1
6782,EU-ivrige,1,2,,1,1,2,,3
6783,magtarrogance,1,2,,1,1,2,,3
6784,http://t.co/0uSOgUuo84,1,2,,1,1,2,,3
6785,Centraladministrationen,6,0,,1,6,0,,6
6786,Vækst,15,9,,3,5,3,,24
6787,øge,122,12,,3,41,4,,134
6788,Yes,270,33,,10,27,3,,303
6789,Prime,1,0,,1,1,0,,1
6790,Ren,227,18,,5,45,4,,245
6791,dokumentarisme,1,0,,1,1,0,,1
6792,Yeah,50,2,,1,50,2,,52
6793,well,50,2,,1,50,2,,52
6794,that's,50,2,,1,50,2,,52
6795,your,62,3,,3,21,1,,65
6796,halvanden,43,4,,1,43,4,,47
6797,https://t.co/5WtigYhC3d,1,1,,1,1,1,,2
6798,investor,17,1,,2,8,0,,18
6799,DB-aftale,14,1,,1,14,1,,15
6800,dobbeltbeskatning,28,2,,2,14,1,,30
6801,Jersey,14,1,,1,14,1,,15
6802,mængde,127,17,,5,25,3,,144
6803,gylle,46,5,,1,46,5,,51
6804,https://t.co/5RBoXq6NpU,46,5,,1,46,5,,51
6805,Yderligtgående,1,0,,1,1,0,,1
6806,fallit,1,0,,1,1,0,,1
6807,etablere,1,0,,1,1,0,,1
6808,Slagteriarbejdere,2,0,,1,2,0,,2
6809,timeløn,4,0,,2,2,0,,4
6810,ufaglærtes,2,0,,1,2,0,,2
6811,håndværkerløn,2,0,,1,2,0,,2
6812,Smukke,13,9,,1,13,9,,22
6813,nytårsforsæt,11,0,,1,11,0,,11
6814,fjorten,11,0,,1,11,0,,11
6815,århundrede,30,7,,2,15,4,,37
6816,hovedpart,2,1,,1,2,1,,3
6817,menneskeliv,2,1,,1,2,1,,3
6818,islamistiske,2,1,,1,2,1,,3
6819,polemisk,6,2,,2,3,1,,8
6820,ærinde,76,1,,3,25,0,,77
6821,Venstrefløjen,322,22,,1,322,22,,344
6822,stråmand,110,1,,4,28,0,,111
6823,familietid,24,2,,2,12,1,,26
6824,Merete,430,16,,2,215,8,,446
6825,landsformand,317,18,,6,53,3,,335
6826,https://t.co/n1t63V6023,215,8,,1,215,8,,223
6827,teologi,2,1,,1,2,1,,3
6828,Potato,0,0,,1,0,0,,0
6829,potato,0,0,,1,0,0,,0
6830,spejl,0,1,,1,0,1,,1
6831,næstformand,170,15,,5,34,3,,185
6832,Landstinget,110,5,,1,110,5,,115
6833,franskmand,4,5,,1,4,5,,9
6834,Piketty,4,5,,1,4,5,,9
6835,http://t.co/FMvnPfR3nZ,4,5,,1,4,5,,9
6836,censur,151,34,,2,76,17,,185
6837,avis,22,3,,6,4,0,,25
6838,våddragt,145,10,,1,145,10,,155
6839,svømme,186,14,,2,93,7,,200
6840,Kalvehave,145,10,,1,145,10,,155
6841,https://t.co/DtU8dnBJfR,145,10,,1,145,10,,155
6842,rektor,143,3,,1,143,3,,146
6843,DGS,143,3,,1,143,3,,146
6844,omkostning,152,5,,2,76,2,,157
6845,https://t.co/YkMoUa7kxI,30,0,,1,30,0,,30
6846,andelsboliglån,4,1,,1,4,1,,5
6847,andelsværdierne,4,1,,1,4,1,,5
6848,Mikkel,4,1,,1,4,1,,5
6849,Høegh,4,1,,1,4,1,,5
6850,Jyske,4,1,,1,4,1,,5
6851,Lyver,4,1,,1,4,1,,5
6852,JyskeBank,4,1,,1,4,1,,5
6853,falde,4,1,,1,4,1,,5
6854,daværende,3,0,,2,2,0,,3
6855,Løkke-regering,1,0,,1,1,0,,1
6856,Hånden,12,0,,1,12,0,,12
6857,Grundtvigforskning,12,0,,1,12,0,,12
6858,omskæring,133,5,,2,66,2,,138
6859,forhud,47,2,,1,47,2,,49
6860,Vejleproblematikken,3,0,,1,3,0,,3
6861,David,13,0,,2,6,0,,13
6862,Tarp,2,0,,2,1,0,,2
6863,formode,0,0,,1,0,0,,0
6864,fritte,55,8,,3,18,3,,63
6865,instans,85,11,,1,85,11,,96
6866,https://t.co/aabIwQ6fCS,85,11,,1,85,11,,96
6867,slips,21,0,,1,21,0,,21
6868,opportunisme,16,0,,1,16,0,,16
6869,mink”-sagen,16,0,,1,16,0,,16
6870,corona-relateret,50,4,,1,50,4,,54
6871,dagpengesats,50,4,,1,50,4,,54
6872,sats,50,4,,1,50,4,,54
6873,Tror,21,0,,4,5,0,,21
6874,flirt,1,0,,1,1,0,,1
6875,karriere,57,11,,2,28,6,,68
6876,DIPD-arbejde,0,0,,1,0,0,,0
6877,hårdtarbejdende,0,0,,1,0,0,,0
6878,internetfora,0,0,,1,0,0,,0
6879,forhåndscensur,0,0,,1,0,0,,0
6880,tabel,38,0,,3,13,0,,38
6881,https://t.co/Jy62W6N0t7,39,2,,1,39,2,,41
6882,systemtænkningens,3,2,,1,3,2,,5
6883,https://t.co/nJUNZFYkFL,3,2,,1,3,2,,5
6884,Indrømmelse,2,2,,1,2,2,,4
6885,Zornig,2,2,,1,2,2,,4
6886,shitstorm,2,2,,1,2,2,,4
6887,velfortjent,113,5,,2,56,2,,118
6888,førsteplads,105,10,,2,52,5,,115
6889,Nick,43,0,,1,43,0,,43
6890,https://t.co/bdG4ffyWeI,43,0,,1,43,0,,43
6891,frisk,46,3,,1,46,3,,49
6892,Kommunernes,46,3,,1,46,3,,49
6893,Regionernes,46,3,,1,46,3,,49
6894,Løndatakontor,46,3,,1,46,3,,49
6895,https://t.co/oFFn1BfN9C,7,0,,1,7,0,,7
6896,https://t.co/OkcnIOIsLI,7,0,,1,7,0,,7
6897,Kombinationen,152,19,,1,152,19,,171
6898,socialisme-hattrick,152,19,,1,152,19,,171
6899,70erne,152,19,,1,152,19,,171
6900,https://t.co/ejc9CQMnKM,152,19,,1,152,19,,171
6901,MX.dk,22,8,,2,11,4,,30
6902,licens,4,3,,2,2,2,,7
6903,http://t.co/9mYN1cctjA,4,3,,1,4,3,,7
6904,metroxpress,4,3,,1,4,3,,7
6905,udføre,6,1,,1,6,1,,7
6906,Thank,55,15,,3,18,5,,70
6907,grants,11,1,,1,11,1,,12
6908,https://t.co/4wQG4fc5wp,11,1,,1,11,1,,12
6909,Fødevareminister,390,21,,1,390,21,,411
6910,Prehn,390,21,,1,390,21,,411
6911,sundhedsårsager,390,21,,1,390,21,,411
6912,Aha,390,21,,1,390,21,,411
6913,Minkmassegravene,390,21,,1,390,21,,411
6914,Monty,390,21,,1,390,21,,411
6915,Python-agtig,390,21,,1,390,21,,411
6916,https://t.co/uged54NO5Z,390,21,,1,390,21,,411
6917,Christianshavn,6,0,,1,6,0,,6
6918,Inderhavnsbroen,6,0,,1,6,0,,6
6919,tweet,131,9,,8,16,1,,140
6920,Benny,3,0,,2,2,0,,3
6921,Damsgaards,0,0,,1,0,0,,0
6922,intern,16,1,,2,8,0,,17
6923,V-forhold,0,0,,1,0,0,,0
6924,S-DF,11,1,,1,11,1,,12
6925,afholdelse,32,4,,1,32,4,,36
6926,Udskrive,32,4,,1,32,4,,36
6927,eneret,32,4,,1,32,4,,36
6928,valgudskrivelse,32,4,,1,32,4,,36
6929,dato,146,12,,2,73,6,,158
6930,bullshitter,4,0,,1,4,0,,4
6931,vanskelig,4,0,,1,4,0,,4
6932,byområde,1,0,,1,1,0,,1
6933,Vestjylland,4,8,,2,2,4,,12
6934,anseelse,2,4,,1,2,4,,6
6935,Problemer,13,0,,1,13,0,,13
6936,murre,13,0,,1,13,0,,13
6937,fortielse,13,0,,1,13,0,,13
6938,https://t.co/QMOaAjTSyx,13,0,,1,13,0,,13
6939,statsstøtte,28,2,,1,28,2,,30
6940,overgennemsnitlig,28,2,,1,28,2,,30
6941,https://t.co/nEglGBvBKj,28,2,,1,28,2,,30
6942,salafisterne,7,3,,1,7,3,,10
6943,galninge,7,3,,1,7,3,,10
6944,tilregnelig,7,3,,1,7,3,,10
6945,konsekvent,9,4,,2,4,2,,13
6946,vaccinefabrik,52,2,,1,52,2,,54
6947,Olsen,17,9,,1,17,9,,26
6948,studiestartprøven,116,9,,1,116,9,,125
6949,SDU,117,11,,2,58,6,,128
6950,Verdensmålene,116,9,,1,116,9,,125
6951,trojansk,116,9,,1,116,9,,125
6952,Fat,270,18,,2,135,9,,288
6953,https://t.co/Yhucfipbii,116,9,,1,116,9,,125
6954,sump,917,28,,2,458,14,,945
6955,plathed,26,0,,1,26,0,,26
6956,pli,26,0,,1,26,0,,26
6957,skadevirkning,1,0,,1,1,0,,1
6958,marginalskat,1,0,,1,1,0,,1
6959,hæmme,1,0,,1,1,0,,1
6960,udbygning,14,3,,1,14,3,,17
6961,østjyske,14,3,,1,14,3,,17
6962,https://t.co/pdQOFQmRwM,5,0,,1,5,0,,5
6963,gini,0,0,,1,0,0,,0
6964,langvarig,81,5,,1,81,5,,86
6965,recession,81,5,,1,81,5,,86
6966,3F.,81,5,,1,81,5,,86
6967,Forslaget,81,5,,2,40,2,,86
6968,krisetid,81,5,,1,81,5,,86
6969,https://t.co/OdVxkfeJM1,81,5,,1,81,5,,86
6970,retfærdighed,233,27,,7,33,4,,260
6971,kolleger,74,7,,1,74,7,,81
6972,brosten,10,1,,1,10,1,,11
6973,forgæves,73,22,,2,36,11,,95
6974,Holte,0,0,,1,0,0,,0
6975,uddele,2,0,,2,1,0,,2
6976,øretæve,0,0,,1,0,0,,0
6977,V-folk,264,10,,1,264,10,,274
6978,tabu,33,1,,2,16,0,,34
6979,nidkær,28,1,,1,28,1,,29
6980,Straffen,28,1,,1,28,1,,29
6981,udstødelse,28,1,,1,28,1,,29
6982,https://t.co/OAd8DnKfCv,65,1,,1,65,1,,66
6983,Rema,1,1,,1,1,1,,2
6984,Lumsås,1,1,,1,1,1,,2
6985,kone,224,36,,2,112,18,,260
6986,fake,9,1,,2,4,0,,10
6987,hr.,63,0,,1,63,0,,63
6988,Røvrendt,6,0,,1,6,0,,6
6989,koblingsprocenten,49,4,,1,49,4,,53
6990,https://t.co/45EyQL0zFY,49,4,,1,49,4,,53
6991,pseudovidenskab,74,5,,1,74,5,,79
6992,fejlbehæftet,74,5,,1,74,5,,79
6993,RUC-rapport,74,5,,1,74,5,,79
6994,Udlændinge-,74,5,,1,74,5,,79
6995,Integrationsministeriets,74,5,,1,74,5,,79
6996,publikationsliste,74,5,,1,74,5,,79
6997,forskningsfrihed,74,5,,1,74,5,,79
6998,tåbelig,37,0,,2,18,0,,37
6999,uhyggelig,108,16,,2,54,8,,124
7000,biografreklame,58,12,,1,58,12,,70
7001,FT19,58,12,,1,58,12,,70
7002,ftvalg19,95,17,,2,48,8,,112
7003,lyd,132,13,,3,44,4,,145
7004,Nobelfredsprismodtageren,1,1,,1,1,1,,2
7005,Børssalen,9,3,,1,9,3,,12
7006,https://t.co/5WP51dNeTb,9,3,,1,9,3,,12
7007,uforskammet,2,0,,1,2,0,,2
7008,skattepolitik,6,3,,2,3,2,,9
7009,aftalegrundlag,0,0,,1,0,0,,0
7010,S-regeringen,95,16,,3,32,5,,111
7011,nytiltrådte,0,0,,1,0,0,,0
7012,henholde,0,0,,1,0,0,,0
7013,bred,42,5,,4,10,1,,47
7014,slem,57,6,,5,11,1,,63
7015,Emilie,25,2,,1,25,2,,27
7016,Mengs,25,2,,1,25,2,,27
7017,Retten,47,7,,1,47,7,,54
7018,Tendensen,6,0,,1,6,0,,6
7019,spejlblank,4,0,,1,4,0,,4
7020,fræk,117,8,,2,58,4,,125
7021,fiber,2,0,,1,2,0,,2
7022,fremme,379,45,,3,126,15,,424
7023,let,207,27,,6,34,4,,234
7024,https://t.co/D7GpZ9pQ3E,103,12,,1,103,12,,115
7025,Kræftens,2,0,,1,2,0,,2
7026,Bekæmpelse,2,0,,1,2,0,,2
7027,løber,2,0,,1,2,0,,2
7028,http://t.co/SlvuaefARZ,2,0,,1,2,0,,2
7029,Forkert,0,1,,1,0,1,,1
7030,kræftafdeling,0,1,,1,0,1,,1
7031,Hillerød,63,13,,3,21,4,,76
7032,http://t.co/ZrJvTDhoXK,0,1,,1,0,1,,1
7033,ældrepolitik,21,1,,1,21,1,,22
7034,https://t.co/onwWJQLPW0,21,1,,1,21,1,,22
7035,islamisterne,6,2,,2,3,1,,8
7036,https://t.co/COq615D6CD,3,1,,1,3,1,,4
7037,mandag,157,11,,5,31,2,,168
7038,https://t.co/7WKetJMqlt,97,8,,1,97,8,,105
7039,Integrationsministeren,9,2,,1,9,2,,11
7040,https://t.co/U42rsYVgzX,9,2,,1,9,2,,11
7041,utilstedelig,7,2,,1,7,2,,9
7042,Rohksar,7,2,,1,7,2,,9
7043,kop,6,0,,2,3,0,,6
7044,anledning,102,15,,6,17,2,,117
7045,Andreas,0,0,,1,0,0,,0
7046,Anti-vaxxernes,0,0,,1,0,0,,0
7047,teori,0,0,,1,0,0,,0
7048,learn,0,0,,1,0,0,,0
7049,http://t.co/oRL4JIe1hh,0,0,,1,0,0,,0
7050,Færdig,189,9,,2,94,4,,198
7051,https://t.co/Ri0xzadaaH,189,9,,1,189,9,,198
7052,Grab,11,2,,1,11,2,,13
7053,them,11,2,,1,11,2,,13
7054,ussy,11,2,,1,11,2,,13
7055,elitær,14,2,,2,7,1,,16
7056,https://t.co/aodazqNwOu,11,2,,1,11,2,,13
7057,https://t.co/usRBn90Y9R,2,0,,1,2,0,,2
7058,bål,2,0,,1,2,0,,2
7059,snobrød,2,0,,1,2,0,,2
7060,madpakke,2,0,,1,2,0,,2
7061,Næstved,5,2,,1,5,2,,7
7062,Emnet,5,2,,1,5,2,,7
7063,sammenhængskraft,13,5,,3,4,2,,18
7064,Deltagere,5,2,,1,5,2,,7
7065,-Laura,5,2,,1,5,2,,7
7066,https://t.co/mQhLrTeLbI,5,2,,1,5,2,,7
7067,projektuge,84,7,,1,84,7,,91
7068,Klasse,84,7,,1,84,7,,91
7069,Ældstesønnens,84,7,,1,84,7,,91
7070,islamisk,500,103,,8,62,13,,603
7071,diktator,8,2,,1,8,2,,10
7072,indirekte,8,2,,1,8,2,,10
7073,https://t.co/YlievSrOc8,8,2,,1,8,2,,10
7074,socialist,148,16,,3,49,5,,164
7075,kopi,160,20,,2,80,10,,180
7076,https://t.co/gTS9Ct6muA,125,15,,1,125,15,,140
7077,INHUMAN,37,11,,1,37,11,,48
7078,barsk,21,1,,2,10,0,,22
7079,https://t.co/F8h8Mq9FSs,5,0,,1,5,0,,5
7080,Udlændinge,11,1,,1,11,1,,12
7081,https://t.co/jcGdpjAMaF,11,1,,1,11,1,,12
7082,Ozlem,27,5,,1,27,5,,32
7083,smitsom,113,16,,3,38,5,,129
7084,BundenErNåetEndnuEngang,27,5,,1,27,5,,32
7085,https://t.co/oQ0yl6xfI6,27,5,,1,27,5,,32
7086,vås,43,9,,2,22,4,,52
7087,uimodsagt,43,9,,1,43,9,,52
7088,tildeling,101,7,,1,101,7,,108
7089,Harun,101,7,,1,101,7,,108
7090,Demirtas,101,7,,1,101,7,,108
7091,TV2’s,101,7,,1,101,7,,108
7092,agenda,101,7,,1,101,7,,108
7093,forsoningsinterview,101,7,,1,101,7,,108
7094,sprogbrug,101,7,,1,101,7,,108
7095,https://t.co/QoM07CXW7,12,0,,1,12,0,,12
7096,http://t.co/A2ApNex5Gv,1,1,,1,1,1,,2
7097,facebooks,0,0,,1,0,0,,0
7098,fællesskabsbetingelser,0,0,,1,0,0,,0
7099,https://t.co/Gp2uFJXXbG,38,4,,1,38,4,,42
7100,ABONNEMENT,20,7,,1,20,7,,27
7101,UDLÆNDINGEPOLITIKKEN,20,7,,1,20,7,,27
7102,månedlig,287,18,,2,144,9,,305
7103,abonnement,40,14,,2,20,7,,54
7104,Dit,32,7,,2,16,4,,39
7105,sommerfugl,20,1,,1,20,1,,21
7106,https://t.co/OwA3JUXg1e,20,1,,1,20,1,,21
7107,Målrettet,160,16,,1,160,16,,176
7108,https://t.co/lWrqC0pcSf,8,2,,1,8,2,,10
7109,Jalving,9,1,,1,9,1,,10
7110,https://t.co/5O4f8XMmvl,9,1,,1,9,1,,10
7111,tonemestrene,19,3,,1,19,3,,22
7112,jødisk,21,4,,2,10,2,,25
7113,nælde,25,7,,2,12,4,,32
7114,uintegrerbare,16,7,,1,16,7,,23
7115,https://t.co/rZ0mKcuJ3b,16,7,,1,16,7,,23
7116,Flygtningekonventionen,109,31,,3,36,10,,140
7117,Debatindlæg,3,2,,1,3,2,,5
7118,https://t.co/RZZehKHDZz,3,2,,1,3,2,,5
7119,Utallige,61,15,,1,61,15,,76
7120,udvisning,236,52,,4,59,13,,288
7121,barselsregler,61,15,,1,61,15,,76
7122,dagpengeregler,61,15,,1,61,15,,76
7123,børnefamilieydelse,61,15,,1,61,15,,76
7124,https://t.co/SZQLjLAUfc,102,24,,2,51,12,,126
7125,Infantilisering,20,10,,1,20,10,,30
7126,infantilisering,20,10,,1,20,10,,30
7127,erhvervsleder,73,18,,2,36,9,,91
7128,uvidenhed,20,10,,1,20,10,,30
7129,klimaforskning,20,10,,1,20,10,,30
7130,https://t.co/BZURDCotn1,20,10,,1,20,10,,30
7131,MyImaginaryFriend,5,1,,1,5,1,,6
7132,NytParti,5,1,,1,5,1,,6
7133,ViKonservative,5,1,,1,5,1,,6
7134,https://t.co/W1bZktbgz4,5,1,,1,5,1,,6
7135,lovliggørelse,499,31,,1,499,31,,530
7136,sorg,499,31,,1,499,31,,530
7137,tiltro,5,0,,1,5,0,,5
7138,http://t.co/xiZTgOaxFf,2,0,,1,2,0,,2
7139,skjul,2,0,,1,2,0,,2
7140,Jørn,14,3,,1,14,3,,17
7141,Bro,14,3,,1,14,3,,17
7142,politimester,14,3,,1,14,3,,17
7143,operationschef,14,3,,1,14,3,,17
7144,morgenuddelinger,0,0,,1,0,0,,0
7145,Humlebæk,0,0,,1,0,0,,0
7146,velstående,10,0,,1,10,0,,10
7147,EPI,10,0,,1,10,0,,10
7148,Environmental,10,0,,1,10,0,,10
7149,Performance,16,3,,2,8,2,,19
7150,https://t.co/PAFbLWLDQk,10,0,,1,10,0,,10
7151,SOFA,31,2,,1,31,2,,33
7152,CHAISELONG,31,2,,1,31,2,,33
7153,sofa,34,3,,3,11,1,,37
7154,værd,36,3,,4,9,1,,39
7155,rummelig,55,5,,2,28,2,,60
7156,drive,400,216,,3,133,72,,616
7157,passion,0,1,,1,0,1,,1
7158,dygtighed,0,1,,1,0,1,,1
7159,24-årige,0,1,,1,0,1,,1
7160,budgetoverskridelse,0,0,,1,0,0,,0
7161,konstant,0,0,,1,0,0,,0
7162,Viborg,18,3,,2,9,2,,21
7163,demedier,17,3,,1,17,3,,20
7164,https://t.co/IdAI5H5FNv,17,3,,1,17,3,,20
7165,Journalist,1,2,,2,0,1,,3
7166,sikkerhedsforanstaltning,1,0,,1,1,0,,1
7167,gæstebartender,2,0,,2,1,0,,2
7168,Toga,2,0,,2,1,0,,2
7169,sandsugningen,2,0,,1,2,0,,2
7170,Øresund,114,17,,4,28,4,,131
7171,http://t.co/V2Pff0nL9i,2,0,,1,2,0,,2
7172,feber,1,0,,1,1,0,,1
7173,bihule,1,0,,1,1,0,,1
7174,omgang,211,22,,9,23,2,,233
7175,mandeinfluenza,1,0,,1,1,0,,1
7176,blid,1,0,,1,1,0,,1
7177,https://t.co/RkLb6ZJ1w2,1,0,,1,1,0,,1
7178,ministerbetjeningsreglen,30,4,,1,30,4,,34
7179,Mørklægning,30,4,,1,30,4,,34
7180,Tabermarkør,7,1,,1,7,1,,8
7181,bruge,7,1,,1,7,1,,8
7182,racismeanklager,7,1,,1,7,1,,8
7183,Seneste,7,1,,1,7,1,,8
7184,jurastuderende,7,1,,1,7,1,,8
7185,berømmelse,7,1,,1,7,1,,8
7186,https://t.co/O5zgXfrghE,7,1,,1,7,1,,8
7187,Luksusmandag,0,0,,1,0,0,,0
7188,storkriminelle,8,6,,1,8,6,,14
7189,rumæner,8,6,,1,8,6,,14
7190,Facebook-væg,19,3,,1,19,3,,22
7191,radioprogram,19,3,,1,19,3,,22
7192,https://t.co/vHIPE52rIr,19,3,,1,19,3,,22
7193,https://t.co/2mjI0h0VAz,19,3,,1,19,3,,22
7194,joke,0,0,,1,0,0,,0
7195,https://t.co/w3abMoADhj,0,0,,1,0,0,,0
7196,talk,74,13,,2,37,6,,87
7197,husband,2,0,,1,2,0,,2
7198,Your,2,0,,1,2,0,,2
7199,politics,2,0,,1,2,0,,2
7200,Live,1,0,,1,1,0,,1
7201,Vækstfondens,1,0,,1,1,0,,1
7202,deltager,1,0,,1,1,0,,1
7203,Udtalt,0,0,,1,0,0,,0
7204,Ali,1,0,,2,0,0,,1
7205,Parnian,0,0,,1,0,0,,0
7206,sympatierklæringer,0,0,,1,0,0,,0
7207,https://t.co/nvvfCA8YYg,3,1,,1,3,1,,4
7208,magtmenneske,8,3,,1,8,3,,11
7209,https://t.co/9plyoyxH18,8,3,,1,8,3,,11
7210,Blind,7,1,,1,7,1,,8
7211,Tillid,11,2,,2,6,1,,13
7212,Bubber,7,1,,1,7,1,,8
7213,Kanal,7,1,,1,7,1,,8
7214,https://t.co/ej27OlOcMH,7,1,,1,7,1,,8
7215,Livet,10,0,,1,10,0,,10
7216,statsløs,161,36,,2,80,18,,197
7217,MFR,3,0,,1,3,0,,3
7218,FTW,3,0,,1,3,0,,3
7219,meretryghed,5,0,,2,2,0,,5
7220,http://t.co/buZafF674D,3,0,,1,3,0,,3
7221,TV2-dokumentaren,85,12,,1,85,12,,97
7222,dement,85,12,,1,85,12,,97
7223,plejehjemsbeboer,85,12,,1,85,12,,97
7224,Direkte,85,12,,1,85,12,,97
7225,modbydelig,85,12,,1,85,12,,97
7226,lønningspose,85,12,,1,85,12,,97
7227,omsorgsfaget,85,12,,1,85,12,,97
7228,Systemet,85,12,,1,85,12,,97
7229,Schmeichel,30,1,,1,30,1,,31
7230,landshold,30,1,,1,30,1,,31
7231,regionsrådsmedlem,1,0,,1,1,0,,1
7232,tredie,1,0,,1,1,0,,1
7233,kommunalbestyrelsesmedlem,1,0,,1,1,0,,1
7234,https://t.co/vWAjXiqgoq,1,0,,1,1,0,,1
7235,https://t.co/0ohPBCO07i,15,6,,1,15,6,,21
7236,Grundlov,54,10,,1,54,10,,64
7237,https://t.co/FZu88YUsBc,54,10,,1,54,10,,64
7238,Hans-Christian,5,1,,2,2,0,,6
7239,Bruus,13,2,,3,4,1,,15
7240,René,5,1,,2,2,0,,6
7241,Bathum,5,1,,2,2,0,,6
7242,lytter,5,2,,2,2,1,,7
7243,PINLIGT,0,0,,1,0,0,,0
7244,facebook-feed,8,2,,1,8,2,,10
7245,kørekort,25,0,,2,12,0,,25
7246,jage,1,1,,1,1,1,,2
7247,Stem,440,31,,2,220,16,,471
7248,21.,20,2,,1,20,2,,22
7249,november,24,5,,3,8,2,,29
7250,https://t.co/8svU44FtsX,1,1,,1,1,1,,2
7251,live-debat,0,1,,1,0,1,,1
7252,frihedskæmper,21,8,,1,21,8,,29
7253,dronning,432,84,,4,108,21,,516
7254,Mennesket,361,65,,1,361,65,,426
7255,Klimarealisme,361,65,,1,361,65,,426
7256,Kulturminister,13,3,,1,13,3,,16
7257,Bock,13,3,,1,13,3,,16
7258,Grønlænderstiv,13,3,,1,13,3,,16
7259,STOP,6,1,,1,6,1,,7
7260,http://t.co/aot2vI5Pti,6,1,,1,6,1,,7
7261,VerdenIfølgeVermund,21,7,,3,7,2,,28
7262,MindreStatMereMenneske,17,7,,2,8,4,,24
7263,http://t.co/J10mMQKQtp,6,1,,1,6,1,,7
7264,FAA,27,2,,1,27,2,,29
7265,dedikere,27,2,,1,27,2,,29
7266,headset,27,2,,1,27,2,,29
7267,https://t.co/07pZv1F9Rz,27,2,,1,27,2,,29
7268,yes,26,2,,4,6,0,,28
7269,https://t.co/R66JU8fYyf,2,0,,1,2,0,,2
7270,posted,41,6,,6,7,1,,47
7271,https://t.co/5aFdMP7LkN,7,1,,1,7,1,,8
7272,toldsats,1,0,,1,1,0,,1
7273,kunst,0,0,,1,0,0,,0
7274,klynkeri,0,0,,2,0,0,,0
7275,opskrift,32,3,,1,32,3,,35
7276,Værdimæssigt,32,3,,1,32,3,,35
7277,https://t.co/uiv3TMwWta,23,1,,1,23,1,,24
7278,nyeborgerlige,26,1,,2,13,0,,27
7279,mellemøstlig,466,49,,7,67,7,,515
7280,RADIO,242,15,,1,242,15,,257
7281,FREMTID,242,15,,1,242,15,,257
7282,DAB-kanal,242,15,,1,242,15,,257
7283,agere,1,0,,1,1,0,,1
7284,https://t.co/NmOGulMGZq,11,1,,1,11,1,,12
7285,fødevareminIsteren,102,15,,1,102,15,,117
7286,Politikerne,160,36,,6,27,6,,196
7287,eksistentiel,198,27,,2,99,14,,225
7288,overvejelse,204,28,,4,51,7,,232
7289,Voksne,198,27,,2,99,14,,225
7290,frisindet,198,27,,2,99,14,,225
7291,udsagn,18,12,,4,4,3,,30
7292,Rune,125,10,,3,42,3,,135
7293,Selsing,6,1,,1,6,1,,7
7294,Støvring,6,1,,1,6,1,,7
7295,Østeuropas,6,1,,1,6,1,,7
7296,illiberale,6,1,,1,6,1,,7
7297,https://t.co/9S0pSTOQry,6,1,,1,6,1,,7
7298,Kommunerne,16,1,,3,5,0,,17
7299,besserwisserne,29,3,,2,14,2,,32
7300,http://t.co/sfSWJYhvMz,5,0,,1,5,0,,5
7301,Klimapolitikken,211,34,,1,211,34,,245
7302,våben,246,39,,3,82,13,,285
7303,regulering,211,34,,3,70,11,,245
7304,Tragisk,218,36,,2,109,18,,254
7305,vogn,213,34,,2,106,17,,247
7306,tv2,211,34,,2,106,17,,245
7307,EU-medlemskab,12,6,,1,12,6,,18
7308,Samhandel,12,6,,1,12,6,,18
7309,samhandelssamarbejdere,12,6,,1,12,6,,18
7310,https://t.co/hzt6cKNLTH,12,6,,1,12,6,,18
7311,Franskmændenes,6,1,,1,6,1,,7
7312,skæbne,48,15,,3,16,5,,63
7313,franske,64,16,,4,16,4,,80
7314,https://t.co/E2cTnf3n4,6,1,,1,6,1,,7
7315,IS-terrorister,151,36,,1,151,36,,187
7316,IS-afskum,151,36,,1,151,36,,187
7317,albue,151,36,,1,151,36,,187
7318,påskeweekend,111,11,,1,111,11,,122
7319,https://t.co/SNi6NyM9Hi,111,11,,1,111,11,,122
7320,kræftpatient,0,0,,1,0,0,,0
7321,forudsigelig,9,0,,1,9,0,,9
7322,brag,9,0,,1,9,0,,9
7323,europæer,443,32,,3,148,11,,475
7324,Count,161,19,,1,161,19,,180
7325,Europa-politik,161,19,,1,161,19,,180
7326,https://t.co/0B92z59xMj,161,19,,1,161,19,,180
7327,https://t.co/mZX5Bhjy1e,32,6,,1,32,6,,38
7328,Social-,5,1,,1,5,1,,6
7329,Indenrigsministeriets,5,1,,1,5,1,,6
7330,indsamling,199,14,,3,66,5,,213
7331,vælgererklæringer,5,1,,1,5,1,,6
7332,Løsningen,142,29,,4,36,7,,171
7333,klimaudfordringerne,122,24,,1,122,24,,146
7334,imam,42,17,,3,14,6,,59
7335,vers,6,2,,1,6,2,,8
7336,totalitær,66,16,,2,33,8,,82
7337,https://t.co/AdQVRn1gK2,64,16,,1,64,16,,80
7338,forsvarspolitik,8,1,,1,8,1,,9
7339,Just,5,1,,1,5,1,,6
7340,Allinge,5,1,,1,5,1,,6
7341,https://t.co/adGiJWSGqR,5,1,,1,5,1,,6
7342,https://t.co/3wdQyyljhE,16,2,,1,16,2,,18
7343,propfyldt,5,1,,1,5,1,,6
7344,DSB-tog,5,1,,1,5,1,,6
7345,Nivå,5,1,,1,5,1,,6
7346,https://t.co/F5PuxD0DBM,5,1,,1,5,1,,6
7347,https://t.co/8Znwn3LJBi,14,1,,1,14,1,,15
7348,Fremtidens,89,20,,2,44,10,,109
7349,Bjørn,99,15,,2,50,8,,114
7350,Lomborg,97,14,,1,97,14,,111
7351,klimaloven,166,16,,2,83,8,,182
7352,populisme,98,14,,2,49,7,,112
7353,Opslaget,97,14,,1,97,14,,111
7354,modsætning,27,9,,7,4,1,,36
7355,typisk,10,4,,1,10,4,,14
7356,øjensynlig,10,4,,1,10,4,,14
7357,https://t.co/Paa1Ez7j3W,10,4,,1,10,4,,14
7358,Tvede,19,3,,3,6,1,,22
7359,Seiergæstwr,8,0,,1,8,0,,8
7360,kompleks,8,0,,1,8,0,,8
7361,https://t.co/bVn7wQeUJJ,8,0,,1,8,0,,8
7362,sekundmeter,19,2,,1,19,2,,21
7363,rorskade,19,2,,1,19,2,,21
7364,gast,19,2,,1,19,2,,21
7365,tilbøjelighed,19,2,,1,19,2,,21
7366,søsyge,19,2,,1,19,2,,21
7367,KULR15,1,0,,1,1,0,,1
7368,spidskandidat,83,22,,6,14,4,,105
7369,Ketil,4,0,,1,4,0,,4
7370,Wathne,4,0,,1,4,0,,4
7371,Rasmussen,82,4,,4,20,1,,86
7372,danmark,4,0,,1,4,0,,4
7373,selvfølgelighed,4,0,,1,4,0,,4
7374,https://t.co/rIkdzQdJ6,4,0,,1,4,0,,4
7375,småskænderier,108,14,,1,108,14,,122
7376,venteliste,140,29,,2,70,14,,169
7377,offer-/frelserkultur,11,2,,1,11,2,,13
7378,usolidarisk,11,2,,1,11,2,,13
7379,https://t.co/vBOjVsBmmf,11,2,,1,11,2,,13
7380,handicappolitik,3,0,,1,3,0,,3
7381,Klaphatte,3,0,,1,3,0,,3
7382,http://t.co/RqHLt2qZnC,3,0,,1,3,0,,3
7383,ufravigelig,122,26,,3,41,9,,148
7384,NBs,23,5,,1,23,5,,28
7385,https://t.co/dzSi07WFpI,11,4,,1,11,4,,15
7386,farce,171,8,,1,171,8,,179
7387,Offentlig,84,18,,1,84,18,,102
7388,https://t.co/cs8YcTz9iX,84,18,,1,84,18,,102
7389,Overstaten,12,5,,1,12,5,,17
7390,https://t.co/XcaUjYhCVM,12,5,,1,12,5,,17
7391,https://t.co/3umtohcGcL,30,7,,1,30,7,,37
7392,anerkendelse,20,2,,2,10,1,,22
7393,Racisme,0,0,,1,0,0,,0
7394,irrelevant,0,0,,1,0,0,,0
7395,dyremishandling,0,0,,1,0,0,,0
7396,https://t.co/fYiCpOfSVU,34,5,,1,34,5,,39
7397,Strassbourg,2,0,,1,2,0,,2
7398,Svigtet,2,0,,1,2,0,,2
7399,koranklodser,12,2,,1,12,2,,14
7400,https://t.co/GTKweoCHkg,12,2,,1,12,2,,14
7401,MORS,101,13,,1,101,13,,114
7402,DAG,101,13,,1,101,13,,114
7403,Hornbæk,101,13,,1,101,13,,114
7404,indblanding,48,5,,1,48,5,,53
7405,radiostation,48,5,,1,48,5,,53
7406,https://t.co/1S69FNby3J,48,5,,1,48,5,,53
7407,LA-,0,0,,1,0,0,,0
7408,ror,53,12,,2,26,6,,65
7409,Læste,41,2,,1,41,2,,43
7410,miljøministreriet,5,0,,1,5,0,,5
7411,dyreliv,5,0,,1,5,0,,5
7412,migrantkrisen,8,3,,1,8,3,,11
7413,https://t.co/eYfCapFlrh,8,3,,1,8,3,,11
7414,Seiers,4,3,,1,4,3,,7
7415,Fredericia,12,3,,2,6,2,,15
7416,https://t.co/Fd3UTQmQ5W,4,3,,1,4,3,,7
7417,Folketingsvalget,2,0,,1,2,0,,2
7418,https://t.co/cjiSlj00Jb,25,8,,1,25,8,,33
7419,Sundhedspersonalet,55,11,,1,55,11,,66
7420,kompetence,67,15,,3,22,5,,82
7421,danskkundskaber,57,11,,3,19,4,,68
7422,kkonsensus,8,1,,1,8,1,,9
7423,SIDSTE,3,2,,1,3,2,,5
7424,HUS,3,2,,1,3,2,,5
7425,deltage,3,2,,1,3,2,,5
7426,https://t.co/1C3a8yFboN,3,2,,1,3,2,,5
7427,https://t.co/Y1qGaNZekf,21,2,,1,21,2,,23
7428,trossamfund,59,12,,2,30,6,,71
7429,godkendelse,59,12,,1,59,12,,71
7430,menneske-rettighederne,59,12,,1,59,12,,71
7431,trosfrihed,59,12,,1,59,12,,71
7432,https://t.co/IK7TsQ4Si0,78,13,,1,78,13,,91
7433,beslutningstager,4,1,,2,2,0,,5
7434,tv-programmer,2,1,,1,2,1,,3
7435,Pinligt,215,31,,4,54,8,,246
7436,Seier,10,2,,1,10,2,,12
7437,https://t.co/G8qyVuyaMn,10,2,,1,10,2,,12
7438,dametoilet,2,0,,1,2,0,,2
7439,https://t.co/ivy8efOTfe,2,0,,1,2,0,,2
7440,Mina,1,0,,1,1,0,,1
7441,SaudiArabien,1,0,,1,1,0,,1
7442,mekka,1,0,,1,1,0,,1
7443,https://t.co/BSmliUxgU6,25,4,,1,25,4,,29
7444,Partiformand,3,0,,1,3,0,,3
7445,20.,3,0,,1,3,0,,3
7446,https://t.co/QgBiOilJnr,3,0,,1,3,0,,3
7447,verbal,7,3,,1,7,3,,10
7448,lussing,7,3,,1,7,3,,10
7449,jordfordindelsen,7,3,,1,7,3,,10
7450,https://t.co/34cZfBgAPQ,7,3,,1,7,3,,10
7451,mistænke,6,0,,1,6,0,,6
7452,https://t.co/kEZO7DPDEo,6,0,,1,6,0,,6
7453,https://t.co/DpZdoLLGGH,10,1,,1,10,1,,11
7454,https://t.co/focyEHstKD,356,19,,1,356,19,,375
7455,Konservativ,20,3,,1,20,3,,23
7456,Thiesen,20,3,,1,20,3,,23
7457,https://t.co/4Z3RvnJIGM,20,3,,1,20,3,,23
7458,overfald,12,8,,1,12,8,,20
7459,baseballbat,12,8,,1,12,8,,20
7460,Byskov,12,8,,1,12,8,,20
7461,Allé,12,8,,1,12,8,,20
7462,Slagelse,94,26,,2,47,13,,120
7463,juni,17,10,,2,8,5,,27
7464,ærekrænkelse,12,8,,1,12,8,,20
7465,Tæskeholdet,12,8,,1,12,8,,20
7466,https://t.co/jxz2spl6LH,12,8,,1,12,8,,20
7467,https://t.co/DD28IOPD9C,19,3,,1,19,3,,22
7468,Måling,18,5,,1,18,5,,23
7469,storme,18,5,,1,18,5,,23
7470,https://t.co/9O3qJuYbFd,18,5,,1,18,5,,23
7471,monologkaffe,46,10,,1,46,10,,56
7472,øko,76,13,,2,38,6,,89
7473,klima-idealisterne,23,1,,1,23,1,,24
7474,https://t.co/1NUYVSTKUB,23,1,,1,23,1,,24
7475,dkmedier#dkpol,17,1,,1,17,1,,18
7476,politiaktion,189,29,,1,189,29,,218
7477,frygtelighed,189,29,,1,189,29,,218
7478,forsoning,189,29,,1,189,29,,218
7479,https://t.co/BgDW3Wv4kK,189,29,,1,189,29,,218
7480,Jeppe,38,12,,2,19,6,,50
7481,Samuel,29,11,,1,29,11,,40
7482,Cholewa,29,11,,1,29,11,,40
7483,Juhl,29,11,,1,29,11,,40
7484,ubegribelig,17,6,,1,17,6,,23
7485,Afbrændte,0,1,,1,0,1,,1
7486,kandidat,36,6,,4,9,2,,42
7487,radikalisering,0,1,,1,0,1,,1
7488,Tilfælde,0,1,,1,0,1,,1
7489,http://t.co/heXsYphFkE,0,1,,1,0,1,,1
7490,Erkendelse,5,0,,1,5,0,,5
7491,mindrestatmeremenneske,5,0,,1,5,0,,5
7492,https://t.co/mM5dvQh5Bf,5,0,,1,5,0,,5
7493,mastodont,6,2,,1,6,2,,8
7494,mediemarkedet,6,2,,1,6,2,,8
7495,udskiftning,74,14,,1,74,14,,88
7496,arv,75,15,,2,38,8,,90
7497,Jonatan,33,3,,1,33,3,,36
7498,Spang,33,3,,1,33,3,,36
7499,Årets,66,5,,2,33,2,,71
7500,TV-program,33,3,,1,33,3,,36
7501,Zulu-Awards,33,3,,1,33,3,,36
7502,serie,34,3,,2,17,2,,37
7503,tillægspakken,2,0,,1,2,0,,2
7504,LLR,35,14,,4,9,4,,49
7505,EKH,2,0,,1,2,0,,2
7506,DKF,3,0,,2,2,0,,3
7507,køkkenbord,3,0,,1,3,0,,3
7508,https://t.co/Q3cVzH9l2b,3,0,,1,3,0,,3
7509,forstadsfrue,5,2,,1,5,2,,7
7510,https://t.co/CsUskCC04,5,2,,1,5,2,,7
7511,Skatte-finansieret,14,5,,1,14,5,,19
7512,Pris,30,10,,3,10,3,,40
7513,filt,14,5,,1,14,5,,19
7514,windows,14,5,,1,14,5,,19
7515,https://t.co/Qsn6xJTQ2h,14,5,,1,14,5,,19
7516,Svesken,0,0,,1,0,0,,0
7517,disk,0,0,,1,0,0,,0
7518,homoseksuel,11,1,,2,6,0,,12
7519,ikke-muslimer,2,1,,1,2,1,,3
7520,https://t.co/mjFjjSQA3S,8,2,,1,8,2,,10
7521,MeToo-bevægelsen,98,9,,2,49,4,,107
7522,bevise,119,11,,3,40,4,,130
7523,https://t.co/SANZEQhQBb,60,7,,1,60,7,,67
7524,Facebooks,151,34,,1,151,34,,185
7525,frihedsordfører,151,34,,1,151,34,,185
7526,Boje,302,68,,2,151,34,,370
7527,Mathiesen,151,34,,1,151,34,,185
7528,https://t.co/BbA7hBKN8p,151,34,,1,151,34,,185
7529,live-publikum,38,7,,1,38,7,,45
7530,stats-TV,38,7,,1,38,7,,45
7531,Frozen,0,0,,1,0,0,,0
7532,Elsa,0,0,,1,0,0,,0
7533,Draws,0,0,,1,0,0,,0
7534,Joker,0,0,,1,0,0,,0
7535,Minnie,0,0,,1,0,0,,0
7536,Mouse,0,0,,1,0,0,,0
7537,Venom,0,0,,1,0,0,,0
7538,Paw,0,0,,1,0,0,,0
7539,Patrol,0,0,,1,0,0,,0
7540,Chase,0,0,,1,0,0,,0
7541,Real,0,0,,1,0,0,,0
7542,Life,6,0,,2,3,0,,6
7543,https://t.co/AWtaFBvjt9,0,0,,1,0,0,,0
7544,Clickbait,29,2,,1,29,2,,31
7545,https://t.co/6ppQPGoISC,29,2,,1,29,2,,31
7546,https://t.co/owWTV6Fngb,29,2,,1,29,2,,31
7547,skærm,1,0,,1,1,0,,1
7548,1maj15,1,0,,1,1,0,,1
7549,fiske,5,1,,1,5,1,,6
7550,https://t.co/2jmj3FLVGN,5,1,,1,5,1,,6
7551,Jøder,1,0,,1,1,0,,1
7552,Schäfer,2,0,,1,2,0,,2
7553,Innovationsprojekt,2,0,,1,2,0,,2
7554,https://t.co/EyytNcQHzs,5,1,,1,5,1,,6
7555,https://t.co/pUKHFanPev,1,0,,1,1,0,,1
7556,Christina,51,5,,1,51,5,,56
7557,Egelund,51,5,,1,51,5,,56
7558,døjt,51,5,,1,51,5,,56
7559,https://t.co/1WLByqs73,51,5,,1,51,5,,56
7560,Disclaimer,2,0,,1,2,0,,2
7561,Indsamlingsnævnet,2,0,,1,2,0,,2
7562,Ikke-vestlige,21,6,,1,21,6,,27
7563,https://t.co/HWA3SgGYZl,21,6,,1,21,6,,27
7564,Ankommet,16,0,,1,16,0,,16
7565,3-årig,7,1,,1,7,1,,8
7566,https://t.co/DxzoHXvk7,7,1,,1,7,1,,8
7567,Hæv,0,1,,1,0,1,,1
7568,effektivisering,0,1,,1,0,1,,1
7569,https://t.co/0RnQVUXMvH,25,8,,1,25,8,,33
7570,letbane,0,0,,1,0,0,,0
7571,https://t.co/lYj2fGeCLd,9,3,,1,9,3,,12
7572,indflydelsesrig,53,4,,1,53,4,,57
7573,https://t.co/wXjjtiflVF,53,4,,1,53,4,,57
7574,identitet,20,3,,2,10,2,,23
7575,Stiftende,3,0,,1,3,0,,3
7576,Sorø,3,0,,1,3,0,,3
7577,16.,14,1,,2,7,0,,15
7578,Kredsen,3,0,,1,3,0,,3
7579,byrådsmedlem,13,3,,2,6,2,,16
7580,ambassade,26,1,,3,9,0,,27
7581,Jerusalem,4,1,,1,4,1,,5
7582,Vermunds,13,2,,2,6,1,,15
7583,deltagelse,3,3,,2,2,2,,6
7584,https://t.co/j3wFCOIdig,3,2,,1,3,2,,5
7585,virkelyst,9,1,,1,9,1,,10
7586,intolerant,34,8,,1,34,8,,42
7587,dyrebareste,34,8,,1,34,8,,42
7588,Registreringsafgiften,28,6,,1,28,6,,34
7589,benzinafgift,28,6,,1,28,6,,34
7590,ejerafgift,28,6,,1,28,6,,34
7591,https://t.co/AnCQRcsqmb,28,6,,1,28,6,,34
7592,nytår,3,1,,1,3,1,,4
7593,https://t.co/NBvKgg0nXG,3,1,,1,3,1,,4
7594,https://t.co/RASQxUJ5re,22,3,,1,22,3,,25
7595,https://t.co/pXmrEOqQ3S,3,0,,1,3,0,,3
7596,Mercado,37,5,,3,12,2,,42
7597,Undervisningsministeren,34,12,,2,17,6,,46
7598,lektiecafe,0,0,,1,0,0,,0
7599,WTF,1,0,,2,0,0,,1
7600,https://t.co/Zhh2Pb6RCV,22,5,,1,22,5,,27
7601,optræk,2,0,,1,2,0,,2
7602,https://t.co/dHIs4tR2Uh,2,0,,1,2,0,,2
7603,træf,246,31,,1,246,31,,277
7604,udstikke,271,35,,2,136,18,,306
7605,regeltyranni,19,1,,1,19,1,,20
7606,Konsekvensen,38,2,,2,19,1,,40
7607,https://t.co/4J8T4PGD0o,19,1,,1,19,1,,20
7608,https://t.co/y8vDi7JpcW,2,0,,1,2,0,,2
7609,taberhold,12,4,,1,12,4,,16
7610,værdifællesskab,39,10,,3,13,3,,49
7611,https://t.co/i9C3Fd6oFf,12,4,,1,12,4,,16
7612,opgørelse,39,8,,2,20,4,,47
7613,voldsanmeldelser,39,8,,1,39,8,,47
7614,https://t.co/Qaf3noxEQR,39,8,,1,39,8,,47
7615,Frygteligt,77,4,,1,77,4,,81
7616,https://t.co/Wxj19HvHxf,77,4,,1,77,4,,81
7617,Politikerleden,14,7,,2,7,4,,21
7618,https://t.co/kyJ1QRKX1o,7,2,,1,7,2,,9
7619,Skriv,8,0,,2,4,0,,8
7620,https://t.co/SPFEFwcm32,3,0,,1,3,0,,3
7621,https://t.co/1OADlsFYfk,6,0,,1,6,0,,6
7622,https://t.co/0F4SQnhYdq,24,4,,1,24,4,,28
7623,Eiffeltårnet,4,1,,1,4,1,,5
7624,statsleder,4,1,,1,4,1,,5
7625,https://t.co/yP8fW3cTU4,16,2,,1,16,2,,18
7626,Demokratiets,9,2,,1,9,2,,11
7627,Dag,9,2,,2,4,1,,11
7628,Allerød,9,2,,1,9,2,,11
7629,Hvilken,9,2,,1,9,2,,11
7630,https://t.co/NipGWPYDDq,9,2,,1,9,2,,11
7631,folkeskoleprob.i,0,0,,1,0,0,,0
7632,BUTM2015,0,0,,1,0,0,,0
7633,Ide,0,0,,1,0,0,,0
7634,heldagsskole,0,0,,1,0,0,,0
7635,https://t.co/yF5U0x9w4p,15,4,,1,15,4,,19
7636,Useriøst,16,1,,1,16,1,,17
7637,ekstraregning,16,1,,1,16,1,,17
7638,flyafgifter,16,1,,1,16,1,,17
7639,kvotesystem,16,1,,1,16,1,,17
7640,CO2-udledning,16,1,,1,16,1,,17
7641,uændret,16,1,,1,16,1,,17
7642,https://t.co/PlqweAzDDd,16,1,,1,16,1,,17
7643,patetisk,18,1,,1,18,1,,19
7644,fotograf,1,0,,1,1,0,,1
7645,https://t.co/7cVRHS1lA4,1,0,,1,1,0,,1
7646,landsskadelig,68,16,,1,68,16,,84
7647,hellige,68,16,,1,68,16,,84
7648,BTs,68,16,,1,68,16,,84
7649,omfang,2,2,,2,1,1,,4
7650,Tingbjerg,46,5,,2,23,2,,51
7651,Totalt,2,1,,1,2,1,,3
7652,Ting,3,2,,1,3,2,,5
7653,https://t.co/ZlitlttJAc,3,2,,1,3,2,,5
7654,familiemedlem,1,2,,1,1,2,,3
7655,twitterhjerne,1,2,,1,1,2,,3
7656,https://t.co/U1obUbHwcS,1,2,,1,1,2,,3
7657,markedsvilkår,20,3,,2,10,2,,23
7658,Danskerne,391,42,,7,56,6,,433
7659,propaganda,45,9,,2,22,4,,54
7660,kryds,10,1,,1,10,1,,11
7661,https://t.co/bcVJpJNejz,10,1,,1,10,1,,11
7662,https://t.co/QUSNqx1Ffk,30,3,,1,30,3,,33
7663,fundament,43,8,,3,14,3,,51
7664,https://t.co/uOvlwOENUP,5,0,,1,5,0,,5
7665,Centraliseringen,13,3,,1,13,3,,16
7666,sammenlægning,13,3,,1,13,3,,16
7667,nedlægning,13,3,,1,13,3,,16
7668,amt,28,6,,2,14,3,,34
7669,centralisering,23,6,,3,8,2,,29
7670,https://t.co/bJyGxYAQcp,13,3,,1,13,3,,16
7671,medborger,240,32,,5,48,6,,272
7672,gylden,9,1,,1,9,1,,10
7673,https://t.co/Oh54XucaAR,9,1,,1,9,1,,10
7674,http://t.co/RgrBCVHQGl,2,0,,1,2,0,,2
7675,Terror,14,2,,1,14,2,,16
7676,uacceptabel,14,2,,1,14,2,,16
7677,https://t.co/gCXgYQNAzz,14,2,,1,14,2,,16
7678,Meld,1,0,,1,1,0,,1
7679,https://t.co/w9smj7L5Mt,1,0,,1,1,0,,1
7680,Afsenderen,0,0,,1,0,0,,0
7681,fordelagtig,49,15,,1,49,15,,64
7682,klimaminister,49,15,,1,49,15,,64
7683,vejrfænomener,49,15,,1,49,15,,64
7684,Mental,1,0,,1,1,0,,1
7685,kastration,1,0,,1,1,0,,1
7686,E45,2,1,,1,2,1,,3
7687,Østjylland,3,4,,3,1,1,,7
7688,enes,2,0,,1,2,0,,2
7689,https://t.co/3JEaaGbfiY,2,0,,1,2,0,,2
7690,avisstumper,7,1,,1,7,1,,8
7691,https://t.co/Mq4Fz9iOV3,7,1,,1,7,1,,8
7692,krampagtig,55,15,,1,55,15,,70
7693,https://t.co/MD7Dghr8cF,55,15,,1,55,15,,70
7694,tilfældig,142,1,,3,47,0,,143
7695,Johanne,81,15,,4,20,4,,96
7696,Schmidt-Nielsen,57,10,,3,19,3,,67
7697,formandskab,5,0,,1,5,0,,5
7698,ghettomiljøer,21,2,,1,21,2,,23
7699,moske,21,2,,1,21,2,,23
7700,https://t.co/GSRwUwHdYU,21,2,,1,21,2,,23
7701,Soc,14,11,,2,7,6,,25
7702,"budget(19,8",9,11,,1,9,11,,20
7703,mia.)Derfor,9,11,,1,9,11,,20
7704,lampe,9,11,,1,9,11,,20
7705,Lise,59,5,,2,30,2,,64
7706,januarlodtrækningen,10,0,,1,10,0,,10
7707,middag,23,6,,2,12,3,,29
7708,https://t.co/7Tb7ffznZc,10,0,,1,10,0,,10
7709,Nordafrikanske,26,7,,1,26,7,,33
7710,hobetal,26,7,,1,26,7,,33
7711,Libyen,26,7,,1,26,7,,33
7712,kyst,26,7,,1,26,7,,33
7713,ernes,26,7,,1,26,7,,33
7714,skib,32,7,,2,16,4,,39
7715,https://t.co/eXOdJE05uv,26,7,,1,26,7,,33
7716,https://t.co/8eGcohgORC,6,0,,1,6,0,,6
7717,https://t.co/uXHhV4bIP8,16,2,,1,16,2,,18
7718,fortørnet,12,3,,1,12,3,,15
7719,menneskeret,6,2,,1,6,2,,8
7720,studentereksamen,125,16,,2,62,8,,141
7721,boglig,6,2,,1,6,2,,8
7722,https://t.co/juAGzEuBzt,6,2,,1,6,2,,8
7723,Kattekillinger,20,8,,1,20,8,,28
7724,Skattestigning,1,0,,1,1,0,,1
7725,off.,1,0,,1,1,0,,1
7726,gældsætning,1,0,,1,1,0,,1
7727,adm,1,0,,1,1,0,,1
7728,https://t.co/KYM6MKee6,3,2,,1,3,2,,5
7729,https://t.co/tjkm37uQGD,3,0,,1,3,0,,3
7730,globalisering,9,4,,1,9,4,,13
7731,høste,9,4,,1,9,4,,13
7732,årelang,0,0,,1,0,0,,0
7733,https://t.co/Ko4Ld8RDr1,0,0,,1,0,0,,0
7734,ikke-etniske,151,22,,1,151,22,,173
7735,coronatilfælde,151,22,,1,151,22,,173
7736,Genåbningen,151,22,,1,151,22,,173
7737,ligegyldighed,151,22,,1,151,22,,173
7738,tilståelsessag,26,2,,2,13,1,,28
7739,analyse,91,22,,4,23,6,,113
7740,lufthavnsarbejdet,0,0,,1,0,0,,0
7741,østjylland,0,1,,2,0,0,,1
7742,aarhuspol,11,4,,4,3,1,,15
7743,Højlund,2,1,,1,2,1,,3
7744,dame,8,3,,2,4,2,,11
7745,dit,59,13,,1,59,13,,72
7746,https://t.co/eCPRAvR1x9,59,13,,1,59,13,,72
7747,chikane,131,18,,2,66,9,,149
7748,støtteerklæringer,1,0,,1,1,0,,1
7749,https://t.co/ts2w64lYC0,1,0,,1,1,0,,1
7750,herfra,30,8,,1,30,8,,38
7751,https://t.co/dMYUtmwlJy,30,8,,1,30,8,,38
7752,søster,35,5,,2,18,2,,40
7753,https://t.co/v49XufPQkF,4,0,,1,4,0,,4
7754,https://t.co/rzjLVN1mv1,5,2,,1,5,2,,7
7755,dommer,553,16,,2,276,8,,569
7756,kommentator,1,0,,2,0,0,,1
7757,come,0,0,,2,0,0,,0
7758,vmqatar,0,0,,1,0,0,,0
7759,meddelelse,0,0,,1,0,0,,0
7760,http://t.co/jJI9jHzrva,0,0,,1,0,0,,0
7761,genere,17,2,,2,8,1,,19
7762,fløjt,32,12,,1,32,12,,44
7763,https://t.co/vp0JjqArQ9,32,12,,1,32,12,,44
7764,klik,109,33,,2,54,16,,142
7765,hjemmehælpere,65,16,,1,65,16,,81
7766,håndvask,26,3,,1,26,3,,29
7767,stribe,58,4,,3,19,1,,62
7768,vidne,26,3,,1,26,3,,29
7769,https://t.co/MihffA1cTK,26,3,,1,26,3,,29
7770,Krænkelseskulturen,20,2,,1,20,2,,22
7771,Folketingskandidat,22,2,,2,11,1,,24
7772,https://t.co/urILKtLrIX,0,0,,1,0,0,,0
7773,http://t.co/PCoTxvWjGs,0,0,,1,0,0,,0
7774,skrumpe,102,9,,1,102,9,,111
7775,mage,102,9,,1,102,9,,111
7776,Heidelberg,102,9,,1,102,9,,111
7777,Lager,102,9,,1,102,9,,111
7778,https://t.co/FULPW9usUF,102,9,,1,102,9,,111
7779,https://t.co/CILXLEp08Y,15,1,,1,15,1,,16
7780,kostpenge,8,1,,1,8,1,,9
7781,cafeteria,8,1,,1,8,1,,9
7782,asylcenter,8,1,,1,8,1,,9
7783,told,2,0,,1,2,0,,2
7784,hyklerisk,2,0,,1,2,0,,2
7785,narre,76,19,,1,76,19,,95
7786,Lorry,43,13,,1,43,13,,56
7787,mediestøtte,48,14,,2,24,7,,62
7788,valgdebat,43,13,,1,43,13,,56
7789,https://t.co/P5HxWKHOJx,43,13,,1,43,13,,56
7790,Breaking,40,2,,3,13,1,,42
7791,byrådsservice,0,0,,1,0,0,,0
7792,Tilgiv,0,0,,1,0,0,,0
7793,forråelse,27,1,,1,27,1,,28
7794,Jævne,10,7,,1,10,7,,17
7795,utilpasset,10,7,,1,10,7,,17
7796,luksusferier,10,7,,1,10,7,,17
7797,https://t.co/saYQUmBZGi,10,7,,1,10,7,,17
7798,Fredag,22,2,,1,22,2,,24
7799,anahitamalakians,22,2,,1,22,2,,24
7800,KØBENHAVN,35,3,,2,18,2,,38
7801,Kopenhagen,35,3,,2,18,2,,38
7802,https://t.co/I6Ah6ztdPX,22,2,,1,22,2,,24
7803,undergang,10,4,,1,10,4,,14
7804,https://t.co/xtzPGmvaw2,10,4,,1,10,4,,14
7805,redegørelse,287,24,,2,144,12,,311
7806,https://t.co/HhXDHHKbOs,287,24,,1,287,24,,311
7807,Barber,0,0,,1,0,0,,0
7808,Islamisering,10,4,,1,10,4,,14
7809,voldsdominans,10,4,,1,10,4,,14
7810,https://t.co/lW1kciZZAA,24,4,,1,24,4,,28
7811,Barnaby,1,0,,1,1,0,,1
7812,slumre,1,0,,1,1,0,,1
7813,Damn,1,0,,2,0,0,,1
7814,I'm,1,0,,1,1,0,,1
7815,https://t.co/y2X45wu1xq,12,2,,1,12,2,,14
7816,Behandling,136,16,,1,136,16,,152
7817,Mint,136,16,,1,136,16,,152
7818,udkåren,136,16,,1,136,16,,152
7819,familieliv,136,16,,1,136,16,,152
7820,udlændingeproblemer,211,17,,1,211,17,,228
7821,https://t.co/t2HufxKHd0,211,17,,1,211,17,,228
7822,Voldsparate,170,29,,1,170,29,,199
7823,fanatiker,170,29,,1,170,29,,199
7824,Paludan,218,30,,2,109,15,,248
7825,DKpol,324,33,,3,108,11,,357
7826,https://t.co/GVdiWZNA10,170,29,,1,170,29,,199
7827,mobilepay,5,4,,1,5,4,,9
7828,e-mailadresse,10,4,,2,5,2,,14
7829,beskedfeltet,5,4,,1,5,4,,9
7830,bestille,9,4,,2,4,2,,13
7831,højreekstreme,152,12,,1,152,12,,164
7832,suk,152,12,,1,152,12,,164
7833,TV2NEWS,152,12,,1,152,12,,164
7834,titel,26,2,,2,13,1,,28
7835,https://t.co/6IPWfqQDAv,20,1,,1,20,1,,21
7836,offentlighed,54,12,,2,27,6,,66
7837,https://t.co/jzupoKPyT3,3,1,,1,3,1,,4
7838,https://t.co/8yZ6grFoX7,30,4,,1,30,4,,34
7839,paradigmeskifte,22,3,,1,22,3,,25
7840,Stands,102,26,,1,102,26,,128
7841,https://t.co/RFq5BoWgUp,102,26,,1,102,26,,128
7842,Stater,28,5,,1,28,5,,33
7843,EU-flaget,28,5,,1,28,5,,33
7844,forhave,28,5,,1,28,5,,33
7845,Lone,62,4,,2,31,2,,66
7846,Ballerup,10,3,,1,10,3,,13
7847,https://t.co/Lj161a5HrP,12,1,,1,12,1,,13
7848,håndtryksceremonierne,142,16,,1,142,16,,158
7849,afsky,18,2,,1,18,2,,20
7850,Justitsminister,12,2,,1,12,2,,14
7851,https://t.co/PYzG02GPTV,12,2,,1,12,2,,14
7852,uforståelig,36,9,,3,12,3,,45
7853,kvoteflygtnige,5,2,,1,5,2,,7
7854,https://t.co/zl2Q5anC2f,9,1,,1,9,1,,10
7855,Kroll,0,1,,1,0,1,,1
7856,Kaptajn,0,1,,1,0,1,,1
7857,syrienskrigerne,19,4,,1,19,4,,23
7858,stramning,23,4,,3,8,1,,27
7859,https://t.co/oSmMjAXAAt,19,4,,1,19,4,,23
7860,Værdikamp-klar,13,1,,1,13,1,,14
7861,Fodring,0,0,,1,0,0,,0
7862,Renæssanceslot,0,0,,1,0,0,,0
7863,detdanmarkduelsker,0,0,,1,0,0,,0
7864,http://t.co/WtKwt6W28z,0,0,,1,0,0,,0
7865,Soc.,0,0,,1,0,0,,0
7866,gøgleri,0,0,,1,0,0,,0
7867,aarhusianske,0,0,,1,0,0,,0
7868,medlidenhed,7,3,,1,7,3,,10
7869,Rikke,5,0,,1,5,0,,5
7870,https://t.co/BWjbZhcnzE,5,0,,1,5,0,,5
7871,https://t.co/dXTv04USw3,21,5,,1,21,5,,26
7872,gennemgå,12,0,,1,12,0,,12
7873,Cekics,12,0,,1,12,0,,12
7874,lappe,10,2,,1,10,2,,12
7875,udfordring,145,21,,10,14,2,,166
7876,https://t.co/JLBMdUjANk,10,2,,1,10,2,,12
7877,reformliderlig,5,0,,1,5,0,,5
7878,speltmor,5,0,,1,5,0,,5
7879,spelt,5,0,,1,5,0,,5
7880,https://t.co/rNQJS5cLIm,5,0,,1,5,0,,5
7881,Indvandrerbandetyper,146,12,,1,146,12,,158
7882,vanvidskørsel,146,12,,1,146,12,,158
7883,Kystbanen,146,12,,1,146,12,,158
7884,https://t.co/xyd2e8ZLgP,5,0,,1,5,0,,5
7885,føderalistisk,28,7,,1,28,7,,35
7886,magtprojekt,28,7,,1,28,7,,35
7887,https://t.co/Sv65QhuXj0,7,2,,1,7,2,,9
7888,objekt,17,1,,1,17,1,,18
7889,syvende,85,0,,1,85,0,,85
7890,12-tal,85,0,,1,85,0,,85
7891,Grundloven,281,26,,5,56,5,,307
7892,https://t.co/sXyzoS6bJ0,85,0,,1,85,0,,85
7893,børnepasning,39,5,,1,39,5,,44
7894,Levakovic,5,1,,2,2,0,,6
7895,Romertiden,68,0,,1,68,0,,68
7896,Pompei,68,0,,1,68,0,,68
7897,arkitektur,68,0,,1,68,0,,68
7898,Æstetik,68,0,,1,68,0,,68
7899,bygningskunst,68,0,,1,68,0,,68
7900,https://t.co/6U3FQ9Pp5y,34,10,,1,34,10,,44
7901,hykleri,177,39,,3,59,13,,216
7902,pibe,41,9,,1,41,9,,50
7903,flygtningebegrebet,85,24,,1,85,24,,109
7904,misbruge,85,24,,1,85,24,,109
7905,Anden,85,24,,1,85,24,,109
7906,30’erne,85,24,,1,85,24,,109
7907,Ekskluderet,16,7,,1,16,7,,23
7908,sigøjner-gener,16,7,,1,16,7,,23
7909,Hjarn,46,7,,1,46,7,,53
7910,nosse,43,4,,1,43,4,,47
7911,styrke,305,44,,6,51,7,,349
7912,front,43,4,,3,14,1,,47
7913,vinkel,179,67,,2,90,34,,246
7914,bemærkning,20,1,,1,20,1,,21
7915,holde,20,1,,1,20,1,,21
7916,integrationsydelse,4,2,,1,4,2,,6
7917,https://t.co/bLrXjHZVDY,4,2,,1,4,2,,6
7918,morder,223,35,,1,223,35,,258
7919,otteårig,223,35,,1,223,35,,258
7920,kontant,227,36,,2,114,18,,263
7921,belønning,223,35,,1,223,35,,258
7922,integrationsministeren,223,35,,1,223,35,,258
7923,https://t.co/Wt3uTes26B,223,35,,1,223,35,,258
7924,https://t.co/ZyN4ku75ta,7,0,,1,7,0,,7
7925,Byrådet,2,0,,1,2,0,,2
7926,https://t.co/gVMrW00yyn,5,1,,1,5,1,,6
7927,repræsentant,7,1,,1,7,1,,8
7928,Nedtælling,0,0,,1,0,0,,0
7929,dyne,45,1,,2,22,0,,46
7930,kilde,309,53,,5,62,11,,362
7931,drengedrøm,0,0,,1,0,0,,0
7932,elskerinde,1,0,,1,1,0,,1
7933,usmagelig,51,1,,2,26,0,,52
7934,bedrefolkeskole,3,0,,1,3,0,,3
7935,Landsformanden,20,2,,1,20,2,,22
7936,Radikal,20,2,,1,20,2,,22
7937,Ungdom,134,19,,3,45,6,,153
7938,lavalder,20,2,,1,20,2,,22
7939,Ungdomskriminaliteten,20,2,,1,20,2,,22
7940,https://t.co/z2wZ0bQlOr,20,2,,1,20,2,,22
7941,https://t.co/G9jkZMvm7p,21,3,,1,21,3,,24
7942,relativering,330,54,,1,330,54,,384
7943,tv2news,330,54,,1,330,54,,384
7944,https://t.co/O1UgHY35PS,330,54,,1,330,54,,384
7945,erhvervserfaring,49,10,,2,24,5,,59
7946,https://t.co/ig0ujEMZOA,47,10,,1,47,10,,57
7947,Åbne,0,0,,1,0,0,,0
7948,fyraftensmøde,0,0,,1,0,0,,0
7949,folketingskandidat,13,8,,4,3,2,,21
7950,morgenbolledame,19,3,,1,19,3,,22
7951,https://t.co/KmyfJAUTL5,19,3,,1,19,3,,22
7952,Brygger,3,0,,1,3,0,,3
7953,forstad,3,0,,1,3,0,,3
7954,https://t.co/Av0rjJUzWJ,18,6,,1,18,6,,24
7955,tallerken,190,35,,1,190,35,,225
7956,http://t.co/Lf66DZQ2KL,11,6,,1,11,6,,17
7957,http://t.co/2xCCjuOcTX,11,6,,1,11,6,,17
7958,vælgerforening,4,0,,2,2,0,,4
7959,Hillerød-Gribskov,2,0,,1,2,0,,2
7960,lukke,25,4,,1,25,4,,29
7961,RET,25,4,,1,25,4,,29
7962,Velfærd,33,10,,2,16,5,,43
7963,http://t.co/1vOBDPCt6V,6,1,,1,6,1,,7
7964,https://t.co/x6WlXlEHvG,2,0,,1,2,0,,2
7965,styrelse,3,0,,1,3,0,,3
7966,enhed,3,0,,1,3,0,,3
7967,https://t.co/Uhyuhe00Pl,6,2,,1,6,2,,8
7968,Syrienskriger,15,5,,1,15,5,,20
7969,Ahmed,92,19,,3,31,6,,111
7970,Salem,15,5,,1,15,5,,20
7971,el-Haj,15,5,,1,15,5,,20
7972,fortryde,15,5,,1,15,5,,20
7973,kalifat,15,5,,1,15,5,,20
7974,Videoen,15,5,,1,15,5,,20
7975,skød,15,5,,1,15,5,,20
7976,Drop,59,12,,3,20,4,,71
7977,Kulturstøtten,1,0,,1,1,0,,1
7978,dkkomm,1,0,,1,1,0,,1
7979,http://t.co/PL7KI6Y5iN,1,0,,1,1,0,,1
7980,Islams,101,25,,1,101,25,,126
7981,påbud,101,25,,1,101,25,,126
7982,https://t.co/dLPzohqAGm,101,25,,1,101,25,,126
7983,asyl,8,3,,3,3,1,,11
7984,følelsesporno,10,2,,1,10,2,,12
7985,parallelsamfund,2,2,,1,2,2,,4
7986,ekstremisme,2,2,,1,2,2,,4
7987,drdemokrati,2,2,,1,2,2,,4
7988,https://t.co/ywjRJiqlYk,79,16,,1,79,16,,95
7989,omsonst,1,0,,1,1,0,,1
7990,inddrivelse,6,0,,3,2,0,,6
7991,Kongelige,44,3,,1,44,3,,47
7992,Højhed,44,3,,1,44,3,,47
7993,Asger,1,1,,1,1,1,,2
7994,Aamund,1,1,,1,1,1,,2
7995,Glorien,1,0,,1,1,0,,1
7996,puds,1,0,,1,1,0,,1
7997,skamstøtte,1,0,,1,1,0,,1
7998,Bornholm,12,0,,1,12,0,,12
7999,https://t.co/aKAHcdGDYK,12,0,,1,12,0,,12
8000,skolebarn,5,0,,1,5,0,,5
8001,DANSKERE,67,12,,1,67,12,,79
8002,https://t.co/wrMqUqQESB,67,12,,1,67,12,,79
8003,Hansens,272,28,,1,272,28,,300
8004,Eskimo,272,28,,1,272,28,,300
8005,Premier,272,28,,1,272,28,,300
8006,beholde,272,28,,1,272,28,,300
8007,Eskimoen,272,28,,1,272,28,,300
8008,krænkelsestyranniet,272,28,,1,272,28,,300
8009,https://t.co/SDhU1Z9CD5,272,28,,1,272,28,,300
8010,Valget,30,6,,2,15,3,,36
8011,https://t.co/yGz5b36M6E,2,0,,1,2,0,,2
8012,Mød,8,4,,1,8,4,,12
8013,11.,23,6,,2,12,3,,29
8014,TV-Avisen,2,0,,1,2,0,,2
8015,Nordborg,6,0,,1,6,0,,6
8016,https://t.co/eAb693yiig,6,0,,1,6,0,,6
8017,photo,0,1,,1,0,1,,1
8018,https://t.co/a0icEUTU8,0,1,,1,0,1,,1
8019,50kr,0,0,,1,0,0,,0
8020,forslå,0,0,,1,0,0,,0
8021,Nat,0,0,,1,0,0,,0
8022,Problem,0,0,,1,0,0,,0
8023,byfest,4,0,,1,4,0,,4
8024,Jeps,10,0,,2,5,0,,10
8025,Kjærsgaard,16,4,,1,16,4,,20
8026,https://t.co/E0ujqxI2uz,16,4,,1,16,4,,20
8027,Amerikanerne,0,0,,1,0,0,,0
8028,usavalg,0,0,,1,0,0,,0
8029,ULTRA,25,6,,1,25,6,,31
8030,kvindeundertrykkelse,25,6,,1,25,6,,31
8031,skatteborger,25,6,,1,25,6,,31
8032,S.P.,0,0,,1,0,0,,0
8033,intrigere,0,0,,1,0,0,,0
8034,https://t.co/t8ImvxmKBW,10,1,,1,10,1,,11
8035,grundskyld,1,1,,1,1,1,,2
8036,Glade,5,0,,1,5,0,,5
8037,Birkerød,5,0,,1,5,0,,5
8038,grundlovsdag,440,28,,2,220,14,,468
8039,https://t.co/0DQgb3uaP1,5,0,,1,5,0,,5
8040,Forventeligt,4,0,,1,4,0,,4
8041,https://t.co/tyF0jgeeh6,4,0,,1,4,0,,4
8042,SST,162,20,,3,54,7,,182
8043,nytaarstale,1,0,,1,1,0,,1
8044,nytaarstalen,1,0,,1,1,0,,1
8045,https://t.co/BRYwuHCg22,79,14,,1,79,14,,93
8046,Rudersdal,0,0,,2,0,0,,0
8047,Tjo,5,0,,2,2,0,,5
8048,Ulighedskommission,2,0,,1,2,0,,2
8049,Lykketoft,12,7,,3,4,2,,19
8050,kritiker,2,0,,1,2,0,,2
8051,Kravet,2,0,,1,2,0,,2
8052,Uddannelse,105,11,,4,26,3,,116
8053,️-sag,2,0,,1,2,0,,2
8054,Let,2,0,,1,2,0,,2
8055,retskendelse,122,8,,2,61,4,,130
8056,https://t.co/Zc8X22MBYf,120,8,,1,120,8,,128
8057,innovativ,45,7,,2,22,4,,52
8058,talentkonkurrencer,0,2,,1,0,2,,2
8059,http://t.co/rqImaj1LWd,0,2,,1,0,2,,2
8060,burka,4,0,,1,4,0,,4
8061,https://t.co/uaJUUP5K36,4,0,,1,4,0,,4
8062,https://t.co/eYQX0sGHlg,34,8,,1,34,8,,42
8063,sanger,462,28,,1,462,28,,490
8064,hygiejne,545,40,,2,272,20,,585
8065,spredning,462,28,,1,462,28,,490
8066,patogen,462,28,,1,462,28,,490
8067,https://t.co/cKCZrH4zSY,462,28,,1,462,28,,490
8068,norm,4,1,,1,4,1,,5
8069,WD2016,4,1,,1,4,1,,5
8070,bold4her,4,1,,1,4,1,,5
8071,https://t.co/xlUEbHlmT6,4,1,,1,4,1,,5
8072,skæve,2,1,,1,2,1,,3
8073,flyafgift,19,1,,1,19,1,,20
8074,Ungarn,611,29,,3,204,10,,640
8075,Menneskerettighederne,164,21,,1,164,21,,185
8076,GørDanmarkStørre,174,23,,2,87,12,,197
8077,https://t.co/8bqvIIupFT,164,21,,1,164,21,,185
8078,https://t.co/jPwMQq95hZ,5,4,,1,5,4,,9
8079,holsteins,0,0,,1,0,0,,0
8080,Slave,1,0,,1,1,0,,1
8081,AT-AT,1,0,,1,1,0,,1
8082,tand,5,5,,2,2,2,,10
8083,dkeu,3,4,,1,3,4,,7
8084,https://t.co/8cN5qPTHCY,3,4,,1,3,4,,7
8085,rummelighed,1,0,,1,1,0,,1
8086,autismespektrum,1,0,,1,1,0,,1
8087,Straks,3,0,,1,3,0,,3
8088,glimt,55,9,,2,28,4,,64
8089,kig,55,8,,2,28,4,,63
8090,Hegaards,55,8,,1,55,8,,63
8091,kampagnefilm,55,8,,1,55,8,,63
8092,https://t.co/60AwS64UuC,55,8,,1,55,8,,63
8093,omstændighed,3,0,,2,2,0,,3
8094,The,277,63,,9,31,7,,340
8095,Chief,5,0,,1,5,0,,5
8096,indslag,51,1,,1,51,1,,52
8097,Nyhederne,51,1,,1,51,1,,52
8098,smittetal,51,1,,1,51,1,,52
8099,kyndig,51,1,,1,51,1,,52
8100,assistent,51,1,,1,51,1,,52
8101,Asta,51,1,,1,51,1,,52
8102,https://t.co/T0JN6zGJjF,51,1,,1,51,1,,52
8103,embede,14,3,,1,14,3,,17
8104,https://t.co/AOhmBoNSc6,14,3,,1,14,3,,17
8105,Hejs,6,0,,1,6,0,,6
8106,reflektionen,6,0,,1,6,0,,6
8107,FL-partiers,7,0,,1,7,0,,7
8108,førerløs,4,0,,2,2,0,,4
8109,metro,4,1,,4,1,0,,5
8110,klimafinansiering,4,3,,1,4,3,,7
8111,http://t.co/gEXuyeDoIq,4,3,,1,4,3,,7
8112,test,49,11,,2,24,6,,60
8113,Rabalderende,360,44,,1,360,44,,404
8114,islamofobi,360,44,,1,360,44,,404
8115,Florent,0,0,,1,0,0,,0
8116,http://t.co/VpusA7Idpj,1,1,,1,1,1,,2
8117,Mig,12,2,,2,6,1,,14
8118,drgrandprix,11,2,,1,11,2,,13
8119,https://t.co/P8SEtBnSiW,11,2,,1,11,2,,13
8120,musikkonkurrence,0,0,,1,0,0,,0
8121,nedgang,0,0,,1,0,0,,0
8122,affære,0,0,,1,0,0,,0
8123,Avnstrup,0,0,,1,0,0,,0
8124,sommervagt,87,5,,1,87,5,,92
8125,https://t.co/rTtIUOdYI8,87,5,,1,87,5,,92
8126,parlament,69,8,,2,34,4,,77
8127,fatal,90,8,,2,45,4,,98
8128,nationalisme,59,7,,1,59,7,,66
8129,https://t.co/jHWEyy19Pp,59,7,,1,59,7,,66
8130,Egedal,14,1,,1,14,1,,15
8131,bagland,14,1,,1,14,1,,15
8132,https://t.co/6jC1PHcPsh,14,1,,1,14,1,,15
8133,Make,9,4,,1,9,4,,13
8134,America,9,4,,1,9,4,,13
8135,https://t.co/sb1AdIiIID,9,4,,1,9,4,,13
8136,Børns,150,20,,2,75,10,,170
8137,http://t.co/WK3dllw8yP,1,1,,1,1,1,,2
8138,Minus,0,0,,1,0,0,,0
8139,samtale,133,16,,7,19,2,,149
8140,face-to-face,0,0,,1,0,0,,0
8141,Minus2,0,0,,1,0,0,,0
8142,ekko-kammer,0,0,,1,0,0,,0
8143,sårbarhed,6,1,,2,3,0,,7
8144,algoritme,0,0,,1,0,0,,0
8145,feed,9,2,,3,3,1,,11
8146,manipulation,0,0,,1,0,0,,0
8147,udnyttelse,0,0,,1,0,0,,0
8148,https://t.co/gFSLi6rSRH,6,1,,1,6,1,,7
8149,antageligvis,119,14,,1,119,14,,133
8150,Sedra,119,14,,1,119,14,,133
8151,Assad,142,22,,2,71,11,,164
8152,Indvandrere,1,0,,1,1,0,,1
8153,hastelove,16,1,,1,16,1,,17
8154,coronaepidemien,16,1,,1,16,1,,17
8155,https://t.co/XaMDbcSUFw,16,1,,1,16,1,,17
8156,Ryborgs,2,1,,1,2,1,,3
8157,skyld!!111,2,1,,1,2,1,,3
8158,https://t.co/DsAuun9qPW,2,1,,1,2,1,,3
8159,forståelsespapiret,347,30,,4,87,8,,377
8160,https://t.co/1iwDNK0Ilp,13,3,,1,13,3,,16
8161,ydre,92,19,,2,46,10,,111
8162,lejr,702,49,,4,176,12,,751
8163,https://t.co/PcVFhzzk4,7,4,,1,7,4,,11
8164,same-same,1,0,,1,1,0,,1
8165,AGF-ambassadør,7,0,,1,7,0,,7
8166,AGF-trøjen,7,0,,1,7,0,,7
8167,stadion,10,0,,2,5,0,,10
8168,løbebane,7,0,,1,7,0,,7
8169,Hvi,7,0,,1,7,0,,7
8170,polterabend,7,0,,1,7,0,,7
8171,Aros,7,0,,1,7,0,,7
8172,hjemmekamp,7,0,,1,7,0,,7
8173,ksdh,41,0,,2,20,0,,41
8174,https://t.co/SiEZc0QvgW,7,0,,1,7,0,,7
8175,Thea,28,1,,1,28,1,,29
8176,https://t.co/1R26T2Tbob,28,1,,1,28,1,,29
8177,MFere,7,1,,2,4,0,,8
8178,valgbarhed,1,0,,1,1,0,,1
8179,frihedsstraf,1,0,,1,1,0,,1
8180,https://t.co/JSjvAmdxZ2,1,0,,1,1,0,,1
8181,nuancere,12,4,,4,3,1,,16
8182,arbmark,0,0,,1,0,0,,0
8183,ledighed&amp;kommer,0,0,,1,0,0,,0
8184,http://t.co/UyxnumqcpI,0,0,,1,0,0,,0
8185,kontrolsager,0,0,,1,0,0,,0
8186,Yehaa,2,0,,1,2,0,,2
8187,Rohdes,2,0,,1,2,0,,2
8188,curling,17,3,,1,17,3,,20
8189,https://t.co/xiCpIg1NdO,17,3,,1,17,3,,20
8190,forventelig,48,1,,1,48,1,,49
8191,https://t.co/OhuuhfSiTu,48,1,,1,48,1,,49
8192,EU-begejstringen,10,5,,1,10,5,,15
8193,groteskt,10,5,,1,10,5,,15
8194,Klaudi,4,1,,1,4,1,,5
8195,prof.højskolerne,4,1,,1,4,1,,5
8196,Dalai,16,11,,1,16,11,,27
8197,Lamas,16,11,,1,16,11,,27
8198,venskab,170,44,,3,57,15,,214
8199,klogmand,16,11,,1,16,11,,27
8200,http://t.co/7FAh3r3w1i,16,11,,1,16,11,,27
8201,klemme,31,8,,3,10,3,,39
8202,formål,60,17,,4,15,4,,77
8203,hænge,128,9,,1,128,9,,137
8204,forløsning,128,9,,1,128,9,,137
8205,samtykke-loven,128,9,,1,128,9,,137
8206,sex,130,9,,2,65,4,,139
8207,straffelov,128,9,,1,128,9,,137
8208,https://t.co/wCMwSUBfLR,128,9,,1,128,9,,137
8209,https://t.co/AwAsAeP4xi,128,9,,1,128,9,,137
8210,ændringsforslag,4,0,,2,2,0,,4
8211,Tvangsbehandling,2,0,,1,2,0,,2
8212,epidemiberedskabet,2,0,,1,2,0,,2
8213,epidemiloven,2,0,,1,2,0,,2
8214,opsummering,0,0,,1,0,0,,0
8215,hovedbudskab,0,0,,1,0,0,,0
8216,uværdig,54,15,,2,27,8,,69
8217,https://t.co/neL0QmlXqj,8,7,,1,8,7,,15
8218,lovsjusk,10,2,,1,10,2,,12
8219,finanslovspanik,10,2,,1,10,2,,12
8220,https://t.co/NyO3KbBFgy,10,2,,1,10,2,,12
8221,skrue,84,11,,1,84,11,,95
8222,variant,84,11,,1,84,11,,95
8223,B.1.1.7,84,11,,1,84,11,,95
8224,comorbiditet,3,0,,1,3,0,,3
8225,pneumokok,3,0,,1,3,0,,3
8226,influenza,3,0,,1,3,0,,3
8227,prognose,3,0,,1,3,0,,3
8228,opholdstill,5,0,,1,5,0,,5
8229,dansk-kompetencer,5,0,,1,5,0,,5
8230,vægte,5,0,,2,2,0,,5
8231,tilknytning,31,6,,3,10,2,,37
8232,EngangVarJegFlygtning,19,1,,2,10,0,,20
8233,Onkel,85,5,,1,85,5,,90
8234,Reje,85,5,,1,85,5,,90
8235,lakridspibe,85,5,,1,85,5,,90
8236,Sandhedens,0,1,,1,0,1,,1
8237,legohouse,0,1,,1,0,1,,1
8238,modregning,1,0,,1,1,0,,1
8239,fattigdomsydelserne,24,2,,2,12,1,,26
8240,akraftglade,3,3,,1,3,3,,6
8241,affaldsdebatten,3,3,,1,3,3,,6
8242,Risø,3,3,,1,3,3,,6
8243,reaktor,3,3,,1,3,3,,6
8244,Aner,2,0,,1,2,0,,2
8245,frontpersonale,2,0,,1,2,0,,2
8246,kæreste,217,41,,4,54,10,,258
8247,mursten,90,17,,1,90,17,,107
8248,grænsemur,90,17,,1,90,17,,107
8249,https://t.co/gszqYGEEdE,90,17,,1,90,17,,107
8250,R-e-s-p-e-c-t,5,0,,1,5,0,,5
8251,VK-uansvarlighed,0,0,,1,0,0,,0
8252,Myndighederne,11,3,,1,11,3,,14
8253,Pandemien,11,3,,1,11,3,,14
8254,frygte,11,3,,1,11,3,,14
8255,fornøden,11,3,,1,11,3,,14
8256,forholdsregel,11,3,,1,11,3,,14
8257,Proportionerne,11,3,,1,11,3,,14
8258,https://t.co/ykn4v0eFYz,11,3,,1,11,3,,14
8259,femmer,1,1,,1,1,1,,2
8260,mars,3,0,,1,3,0,,3
8261,tjans,65,1,,1,65,1,,66
8262,allerforrest,65,1,,1,65,1,,66
8263,koncert,79,5,,3,26,2,,84
8264,Give,65,1,,1,65,1,,66
8265,https://t.co/uASsPP7uLM,65,1,,1,65,1,,66
8266,advarsel,6,1,,1,6,1,,7
8267,kritikpunkt,6,1,,1,6,1,,7
8268,fejlraten,6,1,,1,6,1,,7
8269,bolsjestribede,1,0,,1,1,0,,1
8270,https://t.co/K2rDZE9gCq,1,1,,1,1,1,,2
8271,morgenbladet,12,0,,1,12,0,,12
8272,Christen,19,10,,2,10,5,,29
8273,Berg,12,0,,1,12,0,,12
8274,Those,12,0,,1,12,0,,12
8275,were,12,0,,1,12,0,,12
8276,days,12,0,,1,12,0,,12
8277,skydevåben,170,8,,2,85,4,,178
8278,https://t.co/gBOERrgtZq,65,7,,1,65,7,,72
8279,Turn,3,1,,1,3,1,,4
8280,Loose,3,1,,1,3,1,,4
8281,Swans,3,1,,1,3,1,,4
8282,Dying,3,1,,1,3,1,,4
8283,Bride,3,1,,1,3,1,,4
8284,Crown,3,1,,1,3,1,,4
8285,Sympathy,3,1,,1,3,1,,4
8286,https://t.co/pd2BgmEpLd,3,1,,1,3,1,,4
8287,Type,3,1,,1,3,1,,4
8288,Negative,3,1,,1,3,1,,4
8289,favoritband,3,1,,1,3,1,,4
8290,Woman,3,1,,1,3,1,,4
8291,https://t.co/lDMOHI1APL,3,1,,1,3,1,,4
8292,Paradise,3,1,,1,3,1,,4
8293,Lost,3,1,,1,3,1,,4
8294,Enchantment,3,1,,1,3,1,,4
8295,https://t.co/xf5EyMJuFq,3,1,,1,3,1,,4
8296,https://t.co/MNFzWusUIU,4,1,,1,4,1,,5
8297,https://t.co/EcfN9N1fFA,4,1,,1,4,1,,5
8298,https://t.co/2aFMXaKStE,3,1,,1,3,1,,4
8299,Instrukskommissionens,71,1,,1,71,1,,72
8300,delberetning,71,1,,1,71,1,,72
8301,jurist,76,2,,2,38,1,,78
8302,hat,37,3,,1,37,3,,40
8303,Shitbra,37,3,,1,37,3,,40
8304,søsterparti,37,3,,1,37,3,,40
8305,https://t.co/FGc5RDOazS,37,3,,1,37,3,,40
8306,Forarbejdet,2,0,,1,2,0,,2
8307,nysgerrig,22,8,,1,22,8,,30
8308,https://t.co/LxISGLww0,22,8,,1,22,8,,30
8309,klemt,1,0,,1,1,0,,1
8310,uddannelsesmuligheder,28,15,,1,28,15,,43
8311,https://t.co/Z9e4Xjjche,28,15,,1,28,15,,43
8312,indkøb,0,0,,1,0,0,,0
8313,Ansaldo,0,0,,1,0,0,,0
8314,hyre,0,0,,1,0,0,,0
8315,studieplads,14,2,,1,14,2,,16
8316,sabbatårsplaner,14,2,,1,14,2,,16
8317,fremtidsdrøm,14,2,,1,14,2,,16
8318,https://t.co/5tv2Ka4ChS,14,2,,1,14,2,,16
8319,medlemskab,316,31,,3,105,10,,347
8320,https://t.co/i9QkZ1TmG5,24,14,,1,24,14,,38
8321,sifi,0,0,,1,0,0,,0
8322,hinanden,10,5,,2,5,2,,15
8323,magthierarki,2,0,,1,2,0,,2
8324,gravid,2,0,,1,2,0,,2
8325,fake-news,2,0,,1,2,0,,2
8326,Bødskov,34,0,,1,34,0,,34
8327,håndmad,34,0,,1,34,0,,34
8328,træk,34,0,,1,34,0,,34
8329,AGFBIF,34,0,,1,34,0,,34
8330,juleøl,34,0,,1,34,0,,34
8331,vinterpausen,34,0,,1,34,0,,34
8332,https://t.co/1luIC0dGsK,34,0,,1,34,0,,34
8333,Formel,23,1,,1,23,1,,24
8334,K-Mag,23,1,,1,23,1,,24
8335,J-mak,23,1,,1,23,1,,24
8336,Thanks,260,31,,3,87,10,,291
8337,Mr.,23,1,,1,23,1,,24
8338,https://t.co/rZyFBb93Tk,83,6,,1,83,6,,89
8339,Offentlighedsloven,48,5,,1,48,5,,53
8340,AaB.,1,0,,1,1,0,,1
8341,https://t.co/NqESHzgiv9,4,1,,1,4,1,,5
8342,Datteren,2,1,,1,2,1,,3
8343,https://t.co/gseV81gwmW,2,0,,1,2,0,,2
8344,senior,26,4,,2,13,2,,30
8345,skrøbelig,24,3,,1,24,3,,27
8346,https://t.co/CU3Bz1X50S,24,3,,1,24,3,,27
8347,seks-dages,2,1,,1,2,1,,3
8348,sundhedsbekæmpelsen,2,1,,1,2,1,,3
8349,EU-ret,2,1,,1,2,1,,3
8350,EU-borger,138,23,,2,69,12,,161
8351,tjenesteydelse,2,1,,1,2,1,,3
8352,https://t.co/lG0VTRzcdv,2,1,,1,2,1,,3
8353,proportionel,2,0,,1,2,0,,2
8354,Insisterede,242,11,,1,242,11,,253
8355,køb,307,13,,3,102,4,,320
8356,Ansvarlig,242,11,,1,242,11,,253
8357,Yay,242,11,,1,242,11,,253
8358,https://t.co/OJO8vtipgu,242,11,,1,242,11,,253
8359,Janus,1,0,,1,1,0,,1
8360,ovn,38,0,,1,38,0,,38
8361,fjernsyn,122,1,,2,61,0,,123
8362,https://t.co/B6vpd1XAsr,38,0,,1,38,0,,38
8363,ligestillingsområde,10,1,,1,10,1,,11
8364,ordbog,10,1,,1,10,1,,11
8365,https://t.co/RC3fAmNbP4,10,1,,1,10,1,,11
8366,epidemi,158,20,,3,53,7,,178
8367,Smittetallene,83,12,,1,83,12,,95
8368,Afstand,83,12,,1,83,12,,95
8369,nytårsaften,83,12,,1,83,12,,95
8370,efteruddannelse,7,2,,2,4,1,,9
8371,From,215,41,,2,108,20,,256
8372,distrust,11,11,,1,11,11,,22
8373,close,115,43,,2,58,22,,158
8374,borde,11,11,,1,11,11,,22
8375,success,74,22,,2,37,11,,96
8376,hope,24,12,,2,12,6,,36
8377,around,11,11,,1,11,11,,22
8378,Europe,36,38,,3,12,13,,74
8379,elsewhere,11,11,,1,11,11,,22
8380,medansvar,2,1,,2,1,0,,3
8381,Uha,3,0,,1,3,0,,3
8382,uha,3,0,,1,3,0,,3
8383,yderfløj,13,2,,2,6,1,,15
8384,cirkle,3,0,,1,3,0,,3
8385,Jamen,5,0,,2,2,0,,5
8386,vivileuropa,28,5,,1,28,5,,33
8387,Graakjær,28,5,,1,28,5,,33
8388,gråvejr,28,5,,1,28,5,,33
8389,juleindkøb,28,5,,1,28,5,,33
8390,folkeskolereformen,0,0,,1,0,0,,0
8391,hind,0,0,,1,0,0,,0
8392,engagement,408,72,,7,58,10,,480
8393,undlade,0,0,,1,0,0,,0
8394,skpol,31,5,,1,31,5,,36
8395,https://t.co/he5mzvnupN,31,5,,1,31,5,,36
8396,SATS,12,3,,1,12,3,,15
8397,dksund,30,4,,2,15,2,,34
8398,plade,27,2,,1,27,2,,29
8399,year,44,18,,2,22,9,,62
8400,crisis,41,27,,2,20,14,,68
8401,Ukraine,4,10,,1,4,10,,14
8402,started,4,10,,1,4,10,,14
8403,tragedy,4,10,,1,4,10,,14
8404,Russia,4,10,,1,4,10,,14
8405,deliver,4,10,,1,4,10,,14
8406,Minsk,4,10,,1,4,10,,14
8407,https://t.co/KA8sKbdvvO,2,1,,1,2,1,,3
8408,Kødbyen,0,0,,1,0,0,,0
8409,https://t.co/i8ycmrXv4P,46,3,,1,46,3,,49
8410,top6-slutspillet,10,1,,1,10,1,,11
8411,sldk,47,3,,4,12,1,,50
8412,international,357,46,,3,119,15,,403
8413,Nørremarken,6,2,,1,6,2,,8
8414,vejle,19,3,,2,10,2,,22
8415,http://t.co/0JCpXeog9u,6,2,,1,6,2,,8
8416,Victory,1,2,,1,1,2,,3
8417,mainly,1,2,,1,1,2,,3
8418,paid,1,2,,1,1,2,,3
8419,SPD,16,3,,4,4,1,,19
8420,Local,1,2,,1,1,2,,3
8421,depended,1,2,,1,1,2,,3
8422,specific,1,2,,1,1,2,,3
8423,https://t.co/hVVMPmcaSw,1,2,,1,1,2,,3
8424,Anyway,2,1,,1,2,1,,3
8425,overrepræsentation,2,1,,1,2,1,,3
8426,Uddannelserne,1,0,,1,1,0,,1
8427,uddannelsesbesparelse,1,0,,1,1,0,,1
8428,Vævsanvendelsesregisteret,0,0,,1,0,0,,0
8429,scenarium,9,1,,2,4,0,,10
8430,https://t.co/ln5bkyGit8,1,0,,1,1,0,,1
8431,fed,78,6,,5,16,1,,84
8432,morecrazy,42,2,,1,42,2,,44
8433,8March,42,2,,1,42,2,,44
8434,defystereotypes,42,2,,1,42,2,,44
8435,https://t.co/0iNZpOdvvm,42,2,,1,42,2,,44
8436,https://t.co/HGg3Ajgyvm,29,8,,1,29,8,,37
8437,smagsneutral,3,0,,1,3,0,,3
8438,miljøzone,13,4,,2,6,2,,17
8439,personbil,11,3,,2,6,2,,14
8440,luftforurening,11,3,,1,11,3,,14
8441,sygedag,11,3,,1,11,3,,14
8442,https://t.co/3XDahCNOfV,11,3,,1,11,3,,14
8443,S-tog,8,0,,2,4,0,,8
8444,dsb,4,0,,1,4,0,,4
8445,Støtter,11,3,,1,11,3,,14
8446,domfældelse,11,3,,1,11,3,,14
8447,https://t.co/oNDbBnieUD,8,0,,1,8,0,,8
8448,https://t.co/VWOlykz5Fh,4,3,,1,4,3,,7
8449,bloggen,2,0,,1,2,0,,2
8450,https://t.co/n3jYwHLcnP,2,0,,1,2,0,,2
8451,ansættelse,31,0,,2,16,0,,31
8452,flygtningekrise,12,13,,1,12,13,,25
8453,Ibis,26,18,,1,26,18,,44
8454,PanamaPapers,26,18,,1,26,18,,44
8455,https://t.co/aNsas5G734,26,18,,1,26,18,,44
8456,Paul,3,1,,1,3,1,,4
8457,McCartney,3,1,,1,3,1,,4
8458,Wings,3,1,,1,3,1,,4
8459,https://t.co/eFAl8IqPIE,3,1,,1,3,1,,4
8460,meste,54,7,,4,14,2,,61
8461,redelig,4,0,,1,4,0,,4
8462,ulempe,4,0,,1,4,0,,4
8463,grænselukning,85,12,,2,42,6,,97
8464,begrundelse,108,15,,3,36,5,,123
8465,Stine,8,3,,3,3,1,,11
8466,læringsmål,6,2,,1,6,2,,8
8467,Democratic,1,0,,1,1,0,,1
8468,Paradox,1,0,,1,1,0,,1
8469,Mouffe,1,0,,1,1,0,,1
8470,taknemmelig,38,2,,1,38,2,,40
8471,Türeci,38,2,,1,38,2,,40
8472,https://t.co/X3DePHrCiT,38,2,,1,38,2,,40
8473,ægtefælle,464,79,,4,116,20,,543
8474,ægteskab,150,31,,1,150,31,,181
8475,fædreland,150,31,,1,150,31,,181
8476,https://t.co/Jc1vntMqse,150,31,,1,150,31,,181
8477,filmudgave,1,0,,1,1,0,,1
8478,Indiana,1,0,,1,1,0,,1
8479,Jones,1,0,,1,1,0,,1
8480,Fate,1,0,,1,1,0,,1
8481,Atlantis,1,0,,1,1,0,,1
8482,Dansker,102,23,,1,102,23,,125
8483,ViErLigeDanske,102,23,,1,102,23,,125
8484,https://t.co/ukJBqpbPXw,102,23,,1,102,23,,125
8485,https://t.co/wxa6gl8T3L,22,1,,1,22,1,,23
8486,nabolag,0,0,,1,0,0,,0
8487,https://t.co/PNui9ET6JW,8,3,,1,8,3,,11
8488,skælds,0,0,,1,0,0,,0
8489,Enkelt,11,0,,1,11,0,,11
8490,action,67,12,,3,22,4,,79
8491,card,23,0,,1,23,0,,23
8492,besindighed,34,1,,1,34,1,,35
8493,Sundhedsudvalget,34,1,,1,34,1,,35
8494,https://t.co/Dq4k8kp0Mv,34,1,,1,34,1,,35
8495,tildele,2,5,,1,2,5,,7
8496,vilkårlighed,2,5,,1,2,5,,7
8497,https://t.co/VdLh2FEUje,2,5,,1,2,5,,7
8498,Vurdering,81,7,,1,81,7,,88
8499,terrortruslen,162,14,,2,81,7,,176
8500,højreekstremist,81,7,,1,81,7,,88
8501,https://t.co/TrF6rfLNxF,81,7,,1,81,7,,88
8502,https://t.co/Wo6qsWAaYS,23,2,,1,23,2,,25
8503,Bankunionen,25,6,,1,25,6,,31
8504,hvidvaske,56,9,,3,19,3,,65
8505,finanssektor,25,6,,1,25,6,,31
8506,klumme,39,10,,3,13,3,,49
8507,https://t.co/udjCtZiaM6,25,6,,1,25,6,,31
8508,Snapchat,0,0,,1,0,0,,0
8509,snapQR,0,0,,1,0,0,,0
8510,snapchat,0,0,,1,0,0,,0
8511,http://t.co/4IPLRs3XDy,0,0,,1,0,0,,0
8512,DF&amp;LA,1,0,,1,1,0,,1
8513,udeaføjeudeafsind,1,0,,1,1,0,,1
8514,tilrådighed,33,5,,1,33,5,,38
8515,solidaritet,43,8,,2,22,4,,51
8516,Flertal,33,7,,2,16,4,,40
8517,solidarisk,38,5,,3,13,2,,43
8518,selv”-linjen,33,5,,1,33,5,,38
8519,Fine,2,0,,1,2,0,,2
8520,Nora,2,0,,1,2,0,,2
8521,Grete,0,0,,1,0,0,,0
8522,velskrevet,5,0,,1,5,0,,5
8523,oversigt,5,0,,1,5,0,,5
8524,Meningsmålingerne,142,20,,1,142,20,,162
8525,andetsteds,142,20,,1,142,20,,162
8526,kortsigtet,5,1,,2,2,0,,6
8527,uddannelsesbesparelser,79,10,,2,40,5,,89
8528,SpørgHelveg,8,8,,4,2,2,,16
8529,UddannelseErDetVigtigste,14,3,,1,14,3,,17
8530,fagfælle,1,0,,2,0,0,,1
8531,Iterativ,0,0,,1,0,0,,0
8532,optimering,0,0,,1,0,0,,0
8533,forespørgselsdebat,142,10,,2,71,5,,152
8534,epidemilov,88,3,,1,88,3,,91
8535,Lindgreen,88,3,,1,88,3,,91
8536,https://t.co/THlzMy4zR0,88,3,,1,88,3,,91
8537,fagkundskab,0,0,,1,0,0,,0
8538,sundhedsmæssig,8,1,,1,8,1,,9
8539,sindsyg,45,5,,1,45,5,,50
8540,O2matic,45,5,,1,45,5,,50
8541,Herlev,45,5,,1,45,5,,50
8542,præcisionsbehandling,45,5,,1,45,5,,50
8543,KOL,45,5,,1,45,5,,50
8544,V-møde,45,5,,1,45,5,,50
8545,forskpol,45,5,,1,45,5,,50
8546,https://t.co/Ab7t701NHZ,45,5,,1,45,5,,50
8547,Uni,0,0,,1,0,0,,0
8548,læreruddannelse,7,1,,2,4,0,,8
8549,pædagog-sagen,14,1,,1,14,1,,15
8550,stormvejr,14,1,,1,14,1,,15
8551,https://t.co/kWhFi7M0Qu,14,1,,1,14,1,,15
8552,SpørgRadikale,0,0,,1,0,0,,0
8553,https://t.co/4SotmqPvRR,10,2,,1,10,2,,12
8554,Rønne,49,5,,1,49,5,,54
8555,https://t.co/xhnGJAMP5b,2,1,,1,2,1,,3
8556,Vågne,0,0,,1,0,0,,0
8557,Grænsekontrollen,32,5,,1,32,5,,37
8558,Sønderjylland,37,6,,2,18,3,,43
8559,politisag,32,5,,1,32,5,,37
8560,lillejuleaften,4,1,,1,4,1,,5
8561,klassiker,4,1,,1,4,1,,5
8562,metalbands,4,1,,1,4,1,,5
8563,Escape,4,1,,1,4,1,,5
8564,https://t.co/LjIjHthjyl,4,1,,1,4,1,,5
8565,skatteaftale,26,6,,1,26,6,,32
8566,job-,26,6,,1,26,6,,32
8567,væksteffekt,26,6,,1,26,6,,32
8568,omlægning,91,25,,4,23,6,,116
8569,gørdanmarkstørre,26,6,,1,26,6,,32
8570,TAK,88,4,,3,29,1,,92
8571,Julie,13,2,,1,13,2,,15
8572,hønse,13,2,,1,13,2,,15
8573,Infertilitet,13,2,,1,13,2,,15
8574,https://t.co/pikxkRBUz7,13,2,,1,13,2,,15
8575,Pyha,17,5,,1,17,5,,22
8576,irrationel,17,5,,1,17,5,,22
8577,Farvel,19,6,,1,19,6,,25
8578,Fællessalen,19,6,,1,19,6,,25
8579,årrække,11,0,,1,11,0,,11
8580,avisledere,117,8,,1,117,8,,125
8581,https://t.co/cD9ruM9HOE,117,8,,1,117,8,,125
8582,9-årige,4,0,,1,4,0,,4
8583,Leatherface,4,0,,1,4,0,,4
8584,Freddy,4,0,,1,4,0,,4
8585,halloween-eskapader,4,0,,1,4,0,,4
8586,kviklån,11,1,,1,11,1,,12
8587,Svendestykke,11,1,,1,11,1,,12
8588,strandhus,7,1,,1,7,1,,8
8589,kolding,10,3,,2,5,2,,13
8590,MenneskerMedMeninger,7,1,,1,7,1,,8
8591,https://t.co/URe3OD4VrD,7,1,,1,7,1,,8
8592,uafhængighed,19,23,,1,19,23,,42
8593,http://t.co/JCGC004mzU,19,23,,1,19,23,,42
8594,Eurovision,5,2,,1,5,2,,7
8595,Europa-Parlamentet,5,2,,1,5,2,,7
8596,europapolitikere,5,2,,1,5,2,,7
8597,https://t.co/h2MP8oT6I6,5,2,,1,5,2,,7
8598,Jaaaa,3,0,,1,3,0,,3
8599,Handletanken,3,0,,1,3,0,,3
8600,Børnene,23,6,,1,23,6,,29
8601,covernummerjulekalender,1,1,,1,1,1,,2
8602,version,1,1,,1,1,1,,2
8603,Beatles-medley,1,1,,1,1,1,,2
8604,DetHandlerOmMennesker,15,11,,3,5,4,,26
8605,sundhedsaftale,13,1,,1,13,1,,14
8606,https://t.co/XlRfB3EwlK,13,1,,1,13,1,,14
8607,Beklager,179,32,,2,90,16,,211
8608,teknisk,30,2,,3,10,1,,32
8609,overlæge,1,0,,1,1,0,,1
8610,bureaukratisk,42,11,,2,21,6,,53
8611,https://t.co/gYpDNtuXVj,38,10,,1,38,10,,48
8612,https://t.co/jrsB08prSP,98,26,,1,98,26,,124
8613,suverænitet,10,8,,2,5,4,,18
8614,fejlslutning,2,0,,1,2,0,,2
8615,derude,2,0,,1,2,0,,2
8616,Yucatan,10,3,,1,10,3,,13
8617,bundskat,3,1,,1,3,1,,4
8618,PSO,3,1,,2,2,0,,4
8619,https://t.co/xe2FA8h1Sv,3,1,,1,3,1,,4
8620,departement,5,1,,1,5,1,,6
8621,teledatasag,5,1,,1,5,1,,6
8622,Christine,0,0,,1,0,0,,0
8623,hævnporno,8,3,,1,8,3,,11
8624,brilliant,4,4,,1,4,4,,8
8625,læseværdig,4,4,,1,4,4,,8
8626,Friedman,4,4,,1,4,4,,8
8627,https://t.co/y4Z2pAx9DT,4,4,,1,4,4,,8
8628,bilskat,0,0,,1,0,0,,0
8629,True,2,1,,1,2,1,,3
8630,drab,37,3,,3,12,1,,40
8631,Uzan,2,1,,1,2,1,,3
8632,Investigave,1,0,,1,1,0,,1
8633,interviewing,1,0,,1,1,0,,1
8634,procesagtigt,3,1,,1,3,1,,4
8635,kriminalitetsbekæmpelse,3,1,,1,3,1,,4
8636,topmål,75,18,,1,75,18,,93
8637,livsnerve,75,18,,1,75,18,,93
8638,https://t.co/EA1XP7Ye6n,75,18,,1,75,18,,93
8639,EMRK,38,5,,1,38,5,,43
8640,rettergang,38,5,,1,38,5,,43
8641,https://t.co/ATAgnJ0f20,38,5,,1,38,5,,43
8642,centralistisk,12,7,,1,12,7,,19
8643,grønthøster-besparelser,7,1,,1,7,1,,8
8644,udvisnings-ø,7,1,,1,7,1,,8
8645,Stege,7,1,,1,7,1,,8
8646,Bugt,7,1,,1,7,1,,8
8647,dosis,3,0,,2,2,0,,3
8648,https://t.co/bQqD8IovC4,19,1,,1,19,1,,20
8649,årskarakterne,0,1,,1,0,1,,1
8650,Blackstone,21,3,,1,21,3,,24
8651,https://t.co/Wk1isyH8hy,21,3,,1,21,3,,24
8652,pædagoguddannelse,23,2,,1,23,2,,25
8653,bhvchat,24,3,,2,12,2,,27
8654,https://t.co/jT0hHlACK5,23,2,,1,23,2,,25
8655,soroe17,12,1,,1,12,1,,13
8656,skandinavisk,41,19,,1,41,19,,60
8657,skattesnyd,41,19,,1,41,19,,60
8658,påkrævet,41,19,,1,41,19,,60
8659,Merkelsk,82,5,,1,82,5,,87
8660,begejstring,82,5,,2,41,2,,87
8661,https://t.co/X4387CIhrE,82,5,,1,82,5,,87
8662,https://t.co/F53stnJiDZ,18,7,,1,18,7,,25
8663,pandemi,209,19,,4,52,5,,228
8664,grænseoverskridende,51,8,,2,26,4,,59
8665,udstilling,3,1,,2,2,0,,4
8666,http://t.co/hHgBQIlln3,2,1,,1,2,1,,3
8667,⁦@RadikaleLyngby⁩,18,1,,1,18,1,,19
8668,Rådhus,18,1,,1,18,1,,19
8669,⁦@radikale⁩,141,25,,2,70,12,,166
8670,fælle,18,1,,1,18,1,,19
8671,Opløftende,18,1,,1,18,1,,19
8672,formandsberetning,18,1,,1,18,1,,19
8673,⁦@pauljeppesen⁩,18,1,,1,18,1,,19
8674,https://t.co/5l2x9ceb0Y,18,1,,1,18,1,,19
8675,tvivlsom,0,0,,1,0,0,,0
8676,nydansk,76,12,,2,38,6,,88
8677,kvindekamp,38,6,,1,38,6,,44
8678,magtposition,38,6,,1,38,6,,44
8679,https://t.co/hgRc2OejU9,38,6,,1,38,6,,44
8680,højtryk,40,3,,2,20,2,,43
8681,e-cigaretter,2,0,,1,2,0,,2
8682,tobak,2,0,,1,2,0,,2
8683,herning,4,1,,1,4,1,,5
8684,Investeringernes,4,1,,1,4,1,,5
8685,dktrp,450,62,,15,30,4,,512
8686,Ankersen,0,0,,1,0,0,,0
8687,Retsplejelovens,0,0,,1,0,0,,0
8688,byretsdom,0,0,,1,0,0,,0
8689,Klageret,0,0,,1,0,0,,0
8690,retlig,0,0,,1,0,0,,0
8691,Solbakke,0,0,,1,0,0,,0
8692,https://t.co/nYh2miMfD6,0,0,,1,0,0,,0
8693,kviklånsfirmaer,1,0,,1,1,0,,1
8694,meningsfuld,0,0,,1,0,0,,0
8695,Rania,78,12,,2,39,6,,90
8696,ParadigmeskiftetErDyrtForDanmark,75,12,,1,75,12,,87
8697,Massedrab,31,1,,1,31,1,,32
8698,galskab,62,2,,2,31,1,,64
8699,had,425,48,,5,85,10,,473
8700,polarisering,31,1,,1,31,1,,32
8701,kombination,60,7,,2,30,4,,67
8702,handlingslammelse,31,1,,1,31,1,,32
8703,cadeau,260,4,,1,260,4,,264
8704,tårnhøj,260,4,,1,260,4,,264
8705,klimaambitioner,275,6,,2,138,3,,281
8706,partifnidder,260,4,,1,260,4,,264
8707,oppositionsståhej,260,4,,1,260,4,,264
8708,Respekt,260,4,,1,260,4,,264
8709,https://t.co/Z9TQkXgCO7,260,4,,1,260,4,,264
8710,Nyd,4,0,,2,2,0,,4
8711,journalistisk,70,5,,1,70,5,,75
8712,vedholdenhed,70,5,,1,70,5,,75
8713,Pandoras,70,5,,1,70,5,,75
8714,æske,70,5,,1,70,5,,75
8715,Kritisk,70,5,,1,70,5,,75
8716,karat,70,5,,1,70,5,,75
8717,Twitter-komplimentet,1,0,,1,1,0,,1
8718,fup+spekulation,1,0,,1,1,0,,1
8719,fastholde,1,0,,2,0,0,,1
8720,fjols,161,12,,1,161,12,,173
8721,Hassans,161,12,,1,161,12,,173
8722,begravelse,322,24,,2,161,12,,346
8723,forstyrrelse,161,12,,1,161,12,,173
8724,https://t.co/SVN2VxcTbp,161,12,,1,161,12,,173
8725,Svanemøllens,5,2,,1,5,2,,7
8726,hjemmebane,5,2,,2,2,1,,7
8727,overvælde,1,0,,1,1,0,,1
8728,Konferencen,1,0,,1,1,0,,1
8729,kraeft360,1,0,,1,1,0,,1
8730,ståsted,4,1,,2,2,0,,5
8731,kræft360,1,0,,1,1,0,,1
8732,Tanker,6,3,,2,3,2,,9
8733,https://t.co/Naf0vlBYGQ,0,0,,1,0,0,,0
8734,tilbage-efter-ferie-og-klar-til-ny-sæson,53,6,,1,53,6,,59
8735,https://t.co/VhLknhFELu,89,10,,1,89,10,,99
8736,https://t.co/gNhusRuNg0,1,0,,1,1,0,,1
8737,Sommersted,1,1,,1,1,1,,2
8738,opvækst,2,2,,2,1,1,,4
8739,omsorgsevne,1,1,,1,1,1,,2
8740,Justice,9,0,,1,9,0,,9
8741,All,118,1,,2,59,0,,119
8742,Sørgeligt,42,17,,3,14,6,,59
8743,http://t.co/C5Secfkthy,5,5,,1,5,5,,10
8744,Aabenraa,6,3,,1,6,3,,9
8745,lære,6,3,,1,6,3,,9
8746,https://t.co/IhqqbIDtXk,6,3,,1,6,3,,9
8747,trafik,73,10,,3,24,3,,83
8748,ISIS',0,0,,1,0,0,,0
8749,Forstemmende,0,0,,1,0,0,,0
8750,https://t.co/MzJhZY3UcU,0,0,,1,0,0,,0
8751,Superligaen,84,1,,2,42,0,,85
8752,direkte,105,4,,2,52,2,,109
8753,omegn,115,20,,2,58,10,,135
8754,mute,3,0,,1,3,0,,3
8755,https://t.co/RMp1ON23Sw,34,4,,1,34,4,,38
8756,børnepolitik,28,6,,1,28,6,,34
8757,detgodebørneliv,28,6,,1,28,6,,34
8758,https://t.co/MEoxpkjxYc,28,6,,1,28,6,,34
8759,europe,16,0,,1,16,0,,16
8760,slid,16,0,,1,16,0,,16
8761,slæb,16,0,,1,16,0,,16
8762,rvkrhe@ft.dk,5,0,,1,5,0,,5
8763,DFF,9,0,,1,9,0,,9
8764,Alchemist,5,1,,1,5,1,,6
8765,stjern,5,1,,1,5,1,,6
8766,ministeriel,54,6,,1,54,6,,60
8767,julebonus,3,1,,1,3,1,,4
8768,Nightmare,3,1,,1,3,1,,4
8769,Christmas,3,1,,1,3,1,,4
8770,album,3,1,,1,3,1,,4
8771,coverversioner,3,1,,1,3,1,,4
8772,Kidnap,3,1,,1,3,1,,4
8773,Sandy,3,1,,1,3,1,,4
8774,Claws,3,1,,1,3,1,,4
8775,https://t.co/Xund95pSWx,3,1,,1,3,1,,4
8776,afhøring,12,0,,1,12,0,,12
8777,vidneansvar,12,0,,1,12,0,,12
8778,fleksibel,12,0,,1,12,0,,12
8779,https://t.co/KgVBP7geWP,55,7,,1,55,7,,62
8780,opløfte,190,19,,2,95,10,,209
8781,Kvinderne,110,12,,1,110,12,,122
8782,IGU,110,12,,1,110,12,,122
8783,IntegrationsGrundUddannelse,110,12,,1,110,12,,122
8784,kanel,7,7,,1,7,7,,14
8785,retsakt,7,7,,1,7,7,,14
8786,Nøehhh,7,7,,1,7,7,,14
8787,stemja,7,7,,1,7,7,,14
8788,samtykkeloven,75,3,,1,75,3,,78
8789,homofobi,95,15,,2,48,8,,110
8790,gevind,39,2,,1,39,2,,41
8791,https://t.co/qNGYozsk0,13,4,,1,13,4,,17
8792,Efterår,0,0,,1,0,0,,0
8793,vaccination,0,0,,1,0,0,,0
8794,indlysende,417,20,,1,417,20,,437
8795,tema,417,20,,1,417,20,,437
8796,https://t.co/AOxg2tEEAK,417,20,,1,417,20,,437
8797,stiftelse,3,0,,1,3,0,,3
8798,Umuligt,0,0,,1,0,0,,0
8799,Jep,3,0,,2,2,0,,3
8800,.@regeringDK,3,1,,1,3,1,,4
8801,ungdomsudd,3,1,,1,3,1,,4
8802,pæd.udd,3,1,,1,3,1,,4
8803,Kærligheden,164,17,,3,55,6,,181
8804,landegrænse,142,14,,1,142,14,,156
8805,Filtre,24,1,,1,24,1,,25
8806,svine,24,1,,2,12,0,,25
8807,https://t.co/3VJFefZQjI,24,1,,1,24,1,,25
8808,tegner,68,7,,1,68,7,,75
8809,Albert,68,7,,1,68,7,,75
8810,Uderzo,68,7,,1,68,7,,75
8811,Asterix,68,7,,1,68,7,,75
8812,Goscinny,68,7,,1,68,7,,75
8813,https://t.co/RITUzhCV0p,68,7,,1,68,7,,75
8814,kul,31,19,,2,16,10,,50
8815,endu,1,6,,1,1,6,,7
8816,olie,95,28,,5,19,6,,123
8817,Finanslov,74,12,,1,74,12,,86
8818,opholdskravet,74,12,,1,74,12,,86
8819,danskuddannelse,74,12,,1,74,12,,86
8820,sandelig,74,12,,1,74,12,,86
8821,park,30,13,,1,30,13,,43
8822,klandre,1,1,,1,1,1,,2
8823,venstrepolitistat,1,1,,1,1,1,,2
8824,Europæisk,16,1,,1,16,1,,17
8825,Internationalt,16,1,,1,16,1,,17
8826,udsyn,16,1,,1,16,1,,17
8827,https://t.co/Vv9bmzYsp9,16,1,,1,16,1,,17
8828,karakterbonus,7,3,,1,7,3,,10
8829,snit,7,3,,1,7,3,,10
8830,pakker,114,8,,2,57,4,,122
8831,opholdssted,144,13,,1,144,13,,157
8832,kæft,672,52,,2,336,26,,724
8833,røvrende,594,43,,1,594,43,,637
8834,rorpind,594,43,,1,594,43,,637
8835,nyretningtak,594,43,,1,594,43,,637
8836,https://t.co/3kgpKvyAba,594,43,,1,594,43,,637
8837,halvår,60,0,,1,60,0,,60
8838,frier,60,0,,1,60,0,,60
8839,https://t.co/0ZscDvUGVn,60,0,,1,60,0,,60
8840,navneskift,126,20,,2,63,10,,146
8841,Vandstand,26,5,,1,26,5,,31
8842,Smilets,26,5,,1,26,5,,31
8843,meter,26,5,,1,26,5,,31
8844,storm,115,6,,2,58,3,,121
8845,Idag,26,5,,1,26,5,,31
8846,klimaforandring,295,28,,3,98,9,,323
8847,vandstand,53,14,,2,26,7,,67
8848,Kejserens,15,2,,1,15,2,,17
8849,klæde,19,2,,2,10,1,,21
8850,nutidig,15,2,,1,15,2,,17
8851,Beskidte,138,28,,1,138,28,,166
8852,facilitet,187,39,,2,94,20,,226
8853,Dårlige,138,28,,1,138,28,,166
8854,sanitær,138,28,,1,138,28,,166
8855,hygiejnemæssige,138,28,,1,138,28,,166
8856,Ledninger,138,28,,1,138,28,,166
8857,væg,138,28,,1,138,28,,166
8858,udendørsadgang,138,28,,1,138,28,,166
8859,Konklusion,138,28,,1,138,28,,166
8860,torturkomité,138,28,,1,138,28,,166
8861,uegnet,138,28,,1,138,28,,166
8862,https://t.co/ufCl3pkqaF,138,28,,1,138,28,,166
8863,2020-målene,1,2,,1,1,2,,3
8864,2050-målene,1,2,,1,1,2,,3
8865,teknologisk,9,2,,2,4,1,,11
8866,hurdle,1,2,,1,1,2,,3
8867,lokum,1,0,,1,1,0,,1
8868,armslængdeprincippet,1,0,,1,1,0,,1
8869,Yep,3,0,,1,3,0,,3
8870,succes,135,20,,5,27,4,,155
8871,Billederne,3,0,,1,3,0,,3
8872,kage,68,6,,3,23,2,,74
8873,Juridisk,23,7,,1,23,7,,30
8874,18-års,23,7,,1,23,7,,30
8875,https://t.co/zR3KegkOmA,23,7,,1,23,7,,30
8876,bump,33,2,,1,33,2,,35
8877,fællessange,33,2,,1,33,2,,35
8878,rvlm20,33,2,,1,33,2,,35
8879,https://t.co/y1iJVSQJBs,33,2,,1,33,2,,35
8880,bro,224,13,,3,75,4,,237
8881,blond,198,9,,1,198,9,,207
8882,Ramadan,198,9,,1,198,9,,207
8883,Fehmern,1,1,,1,1,1,,2
8884,Giver,8,1,,2,4,0,,9
8885,eur.,1,1,,1,1,1,,2
8886,Hør,0,0,,1,0,0,,0
8887,WWF,6,3,,1,6,3,,9
8888,Forbes',6,3,,1,6,3,,9
8889,erhvervsklima,9,4,,2,4,2,,13
8890,Climate,6,3,,1,6,3,,9
8891,Change,6,3,,1,6,3,,9
8892,Forbandet,42,2,,1,42,2,,44
8893,kram,42,2,,1,42,2,,44
8894,liiiiige,22,2,,2,11,1,,24
8895,Skive,22,2,,1,22,2,,24
8896,Byråd,22,2,,1,22,2,,24
8897,juleaften,22,2,,1,22,2,,24
8898,Hancock,22,2,,1,22,2,,24
8899,kv17,115,30,,5,23,6,,145
8900,https://t.co/K5BEa2MQaE,22,2,,1,22,2,,24
8901,http://t.co/l3CvW3czhF,3,2,,1,3,2,,5
8902,Klimamarch,3,0,,1,3,0,,3
8903,Novo,5,1,,2,2,0,,6
8904,hindring,3,0,,1,3,0,,3
8905,iværk,60,11,,1,60,11,,71
8906,https://t.co/Fxfk5EKQZP,60,11,,1,60,11,,71
8907,.@mhaarder,6,1,,1,6,1,,7
8908,Pædagoguddannelsen,6,1,,1,6,1,,7
8909,skoleklasse,6,1,,1,6,1,,7
8910,sandstreger,0,0,,1,0,0,,0
8911,grænseregler,58,11,,1,58,11,,69
8912,https://t.co/mLqqU5zLj4,58,11,,1,58,11,,69
8913,Sejt,12,1,,4,3,0,,13
8914,50’erne,22,3,,1,22,3,,25
8915,moralpolitik,22,3,,1,22,3,,25
8916,https://t.co/kn0C7O08Tl,22,3,,1,22,3,,25
8917,tids,75,8,,1,75,8,,83
8918,nysmittede,75,8,,1,75,8,,83
8919,positivprocent,75,8,,1,75,8,,83
8920,https://t.co/5NsZDrEeNZ,75,8,,1,75,8,,83
8921,skønlitteratur,4,0,,1,4,0,,4
8922,ere,4,0,,2,2,0,,4
8923,.@politiken,2,3,,1,2,3,,5
8924,Nordbrandt,2,3,,1,2,3,,5
8925,http://t.co/w8r1f84XWc,2,3,,1,2,3,,5
8926,anvendelse,0,0,,1,0,0,,0
8927,høringssvar,4,0,,1,4,0,,4
8928,Straffelovsrådets,4,0,,1,4,0,,4
8929,betænkning,4,0,,1,4,0,,4
8930,hjemsendelsestanken,173,21,,1,173,21,,194
8931,anliggende,173,21,,1,173,21,,194
8932,anbefale,9,4,,3,3,1,,13
8933,EU-forhandlinger,7,1,,1,7,1,,8
8934,samleje,12,1,,1,12,1,,13
8935,https://t.co/e73RcBTc3W,12,1,,1,12,1,,13
8936,Beyoncé,360,2,,1,360,2,,362
8937,Pfizer,360,2,,1,360,2,,362
8938,http://t.co/21CCSi5MvU,3,2,,1,3,2,,5
8939,Katrin,1,2,,1,1,2,,3
8940,Hjort,1,2,,1,1,2,,3
8941,testresultat,1,2,,1,1,2,,3
8942,cool,213,3,,2,106,2,,216
8943,https://t.co/ARQ9YwbiyW,180,3,,1,180,3,,183
8944,skema,123,21,,2,62,10,,144
8945,hint,122,20,,1,122,20,,142
8946,skrivelse,1,0,,1,1,0,,1
8947,biobankfolk,1,0,,1,1,0,,1
8948,flygtningelejr,51,9,,1,51,9,,60
8949,Jordan,51,9,,1,51,9,,60
8950,Kronprinsen,51,9,,1,51,9,,60
8951,generalsekretær,56,9,,2,28,4,,65
8952,Red,75,14,,2,38,7,,89
8953,75årForBørnene,51,9,,1,51,9,,60
8954,https://t.co/uHPbki2wGH,100,11,,1,100,11,,111
8955,Meeen,7,0,,2,4,0,,7
8956,Kommuniker,1,0,,1,1,0,,1
8957,lovændring,1,0,,1,1,0,,1
8958,Tryghed,4,0,,1,4,0,,4
8959,likes,10,1,,1,10,1,,11
8960,https://t.co/kHe32KlzJ4,10,1,,1,10,1,,11
8961,Blue,1,1,,1,1,1,,2
8962,Robotics,1,1,,1,1,1,,2
8963,beløbsordning,1,1,,1,1,1,,2
8964,https://t.co/gSysoM7JFd,57,3,,1,57,3,,60
8965,vrøvleri,0,0,,1,0,0,,0
8966,Skolepatruljer,84,10,,1,84,10,,94
8967,skolevej,84,10,,1,84,10,,94
8968,skolekammerat,84,10,,1,84,10,,94
8969,mørk,84,10,,1,84,10,,94
8970,trafiksikkerhed,97,12,,2,48,6,,109
8971,skolepatrulje,84,10,,1,84,10,,94
8972,borg,0,1,,1,0,1,,1
8973,mantra,0,1,,1,0,1,,1
8974,ingeneffekt,0,1,,1,0,1,,1
8975,rockwoolfonden,0,1,,1,0,1,,1
8976,https://t.co/L57imjeDVs,0,1,,1,0,1,,1
8977,Lytter,4,0,,1,4,0,,4
8978,gennemgang,15,1,,2,8,0,,16
8979,Spielberg-film,4,0,,1,4,0,,4
8980,hitliste,4,0,,1,4,0,,4
8981,velfærdsområde,3,1,,1,3,1,,4
8982,udsathed,6,1,,1,6,1,,7
8983,https://t.co/41EjtbMv72,6,1,,1,6,1,,7
8984,Helles,0,1,,1,0,1,,1
8985,Asylliga,21,2,,1,21,2,,23
8986,Cup,21,2,,1,21,2,,23
8987,https://t.co/LqpfeBrvG8,2,1,,1,2,1,,3
8988,involvering,6,3,,1,6,3,,9
8989,præsidentvalg,6,3,,1,6,3,,9
8990,https://t.co/oQvavY5dxp,6,3,,1,6,3,,9
8991,gammeldags,9,1,,1,9,1,,10
8992,postkasseuddeling,9,1,,1,9,1,,10
8993,Rigshospitalets,9,1,,1,9,1,,10
8994,kollegium,9,1,,1,9,1,,10
8995,Annelie,9,1,,1,9,1,,10
8996,Lartey,9,1,,1,9,1,,10
8997,Lawson,9,1,,1,9,1,,10
8998,https://t.co/Vfq1iVyMxl,9,1,,1,9,1,,10
8999,Klassekamp,5,4,,1,5,4,,9
9000,Dummies,5,4,,1,5,4,,9
9001,http://t.co/SPNfG7G8cO,5,4,,1,5,4,,9
9002,point,119,21,,3,40,7,,140
9003,Wembley,2,1,,1,2,1,,3
9004,RMATOT,2,1,,1,2,1,,3
9005,COYS,2,1,,1,2,1,,3
9006,Chresten,1,0,,1,1,0,,1
9007,DST,1,0,,1,1,0,,1
9008,KAS202,1,0,,1,1,0,,1
9009,snitte,1,0,,1,1,0,,1
9010,elløbehjul,32,0,,2,16,0,,32
9011,foreløbig,2,0,,1,2,0,,2
9012,indikation,170,3,,2,85,2,,173
9013,uheld,2,0,,1,2,0,,2
9014,https://t.co/oeIOKDSxUL,71,9,,1,71,9,,80
9015,Overskuddet,0,0,,1,0,0,,0
9016,ungdomsarbejde,0,0,,2,0,0,,0
9017,DIUs,0,0,,1,0,0,,0
9018,VM-pulje,0,0,,1,0,0,,0
9019,Rødovre,29,6,,6,5,1,,35
9020,publikum,178,15,,1,178,15,,193
9021,straffe,178,15,,1,178,15,,193
9022,appointment,19,2,,1,19,2,,21
9023,trust,19,2,,1,19,2,,21
9024,experience,52,2,,2,26,1,,54
9025,leadership,29,3,,2,14,2,,32
9026,will,1027,205,,9,114,23,,1232
9027,bringe,125,40,,2,62,20,,165
9028,closer,19,2,,1,19,2,,21
9029,goal,19,2,,1,19,2,,21
9030,AIDS,57,13,,2,28,6,,70
9031,health,19,2,,1,19,2,,21
9032,zerodiscrimination,19,2,,1,19,2,,21
9033,renovering,0,0,,1,0,0,,0
9034,KLtop18,27,7,,1,27,7,,34
9035,udhuling,27,7,,1,27,7,,34
9036,kerne,27,7,,1,27,7,,34
9037,KomPolDK,27,7,,1,27,7,,34
9038,kedeldragt,42,13,,1,42,13,,55
9039,Gudfader,42,13,,1,42,13,,55
9040,https://t.co/mIlcGNblc4,42,13,,1,42,13,,55
9041,skride,80,10,,2,40,5,,90
9042,syltekrukke,0,0,,1,0,0,,0
9043,https://t.co/pYHExIZR7I,0,0,,1,0,0,,0
9044,Alexander,0,0,,1,0,0,,0
9045,Lauritzen,55,11,,2,28,6,,66
9046,skattebase,28,7,,1,28,7,,35
9047,Positiv,28,7,,1,28,7,,35
9048,kovending,28,7,,1,28,7,,35
9049,https://t.co/sj8wWR31EZ,28,7,,1,28,7,,35
9050,modspil,9,1,,1,9,1,,10
9051,vind.,9,1,,1,9,1,,10
9052,svineeksportørerne,13,3,,1,13,3,,16
9053,stridsøkse,13,3,,1,13,3,,16
9054,Dyrevelfærden,13,3,,1,13,3,,16
9055,https://t.co/PNAiTzFSug,13,3,,1,13,3,,16
9056,Statsminister,29,6,,2,14,3,,35
9057,klimapartnerskaber,28,4,,1,28,4,,32
9058,vækstmulighed,28,4,,1,28,4,,32
9059,klimapartnerskab,28,4,,1,28,4,,32
9060,skeptisk,0,1,,1,0,1,,1
9061,nærhed,60,10,,2,30,5,,70
9062,https://t.co/M8fOHrFBKc,0,1,,1,0,1,,1
9063,gadekærsmentalitet,26,2,,1,26,2,,28
9064,tænkning,26,2,,1,26,2,,28
9065,https://t.co/TwQBStqRDP,26,2,,1,26,2,,28
9066,kronjuvel,22,4,,1,22,4,,26
9067,https://t.co/rwZFO9nrGh,22,4,,1,22,4,,26
9068,el-lokomotiver,2,0,,1,2,0,,2
9069,DSBs,2,0,,1,2,0,,2
9070,østriske,2,0,,1,2,0,,2
9071,nattogsvogne,2,0,,1,2,0,,2
9072,Øhhh,2,1,,1,2,1,,3
9073,facts,2,1,,1,2,1,,3
9074,Congratulations,72,13,,1,72,13,,85
9075,Abiy,144,26,,2,72,13,,170
9076,NobelPeacePrize,72,13,,1,72,13,,85
9077,meet,526,124,,5,105,25,,650
9078,two,72,13,,1,72,13,,85
9079,months,72,13,,1,72,13,,85
9080,great,319,33,,2,160,16,,352
9081,impression,197,42,,2,98,21,,239
9082,Together,276,43,,2,138,22,,319
9083,planted,72,13,,1,72,13,,85
9084,tree,72,13,,1,72,13,,85
9085,support,462,141,,5,92,28,,603
9086,his,72,13,,1,72,13,,85
9087,nationwide,72,13,,1,72,13,,85
9088,tree-planting,72,13,,1,72,13,,85
9089,campaign,72,13,,1,72,13,,85
9090,https://t.co/EMDOtDhOG4,72,13,,1,72,13,,85
9091,Advarsel,0,0,,1,0,0,,0
9092,Populisterne,0,0,,1,0,0,,0
9093,https://t.co/nUD64wWAPY,0,0,,1,0,0,,0
9094,jegsigerdetbare,0,0,,1,0,0,,0
9095,mht,4,0,,2,2,0,,4
9096,konsekvensanalyse,0,0,,1,0,0,,0
9097,https://t.co/Fm5QQAe8eL,1,2,,1,1,2,,3
9098,mobilenheder,30,0,,1,30,0,,30
9099,kørsel,30,0,,1,30,0,,30
9100,knallert,30,0,,1,30,0,,30
9101,selvudløser,30,0,,1,30,0,,30
9102,hjelm,30,0,,1,30,0,,30
9103,Hurra,3,4,,1,3,4,,7
9104,BTW,0,0,,1,0,0,,0
9105,https://t.co/MIDVSasMai,0,0,,1,0,0,,0
9106,fodbolddommer,1,1,,1,1,1,,2
9107,Grrrrr,1,0,,1,1,0,,1
9108,sundhedsmin,12,3,,1,12,3,,15
9109,beskæftigelsesmin,12,3,,1,12,3,,15
9110,arb-miljø,12,3,,1,12,3,,15
9111,https://t.co/vGVYe2qd1L,12,3,,1,12,3,,15
9112,formiddagssnak,24,5,,1,24,5,,29
9113,max,24,5,,1,24,5,,29
9114,SletDet,24,5,,1,24,5,,29
9115,Barnet,24,5,,1,24,5,,29
9116,arve,29,2,,1,29,2,,31
9117,dep.cheferne,29,2,,1,29,2,,31
9118,https://t.co/0NSPvSLjwD,29,2,,1,29,2,,31
9119,vejgodstransporten,13,1,,1,13,1,,14
9120,vidnedsbyrd,13,1,,1,13,1,,14
9121,https://t.co/tyzUPLBtDz,13,1,,1,13,1,,14
9122,Plastik,10,1,,1,10,1,,11
9123,P1Debat,10,1,,1,10,1,,11
9124,NHL-stjernerne,6,1,,1,6,1,,7
9125,isdk,6,1,,1,6,1,,7
9126,underkende,2,1,,1,2,1,,3
9127,https://t.co/cSWxWxLOy8,2,1,,1,2,1,,3
9128,skælde,7,0,,1,7,0,,7
9129,Taffel,7,0,,1,7,0,,7
9130,julebordet,7,0,,1,7,0,,7
9131,Kampklar,17,1,,1,17,1,,18
9132,Privatization,20,10,,1,20,10,,30
9133,privatization,20,10,,1,20,10,,30
9134,too,20,10,,1,20,10,,30
9135,https://t.co/ywzJMorSEM,20,10,,1,20,10,,30
9136,Ruben,3,0,,1,3,0,,3
9137,transportpolitik,24,6,,1,24,6,,30
9138,https://t.co/iPrFFB1nkB,24,6,,1,24,6,,30
9139,analogi,1,0,,1,1,0,,1
9140,indrejse,1,0,,1,1,0,,1
9141,Imamloven,1,0,,1,1,0,,1
9142,vedr,31,1,,2,16,0,,32
9143,prædikant,1,0,,1,1,0,,1
9144,nuancering,0,1,,1,0,1,,1
9145,https://t.co/taDD72zcQS,0,1,,1,0,1,,1
9146,dkbiz,0,1,,1,0,1,,1
9147,mætte,51,4,,1,51,4,,55
9148,skørt,71,2,,1,71,2,,73
9149,formelfredag,71,2,,1,71,2,,73
9150,HappyNewYear,71,2,,1,71,2,,73
9151,https://t.co/QoNN6MUuWZ,71,2,,1,71,2,,73
9152,plastik,111,14,,3,37,5,,125
9153,GrønRegering,77,3,,1,77,3,,80
9154,https://t.co/bgz1c6Z7Am,77,3,,1,77,3,,80
9155,Hansen,102,19,,3,34,6,,121
9156,Stiftstidende,0,3,,1,0,3,,3
9157,spolitik,0,3,,1,0,3,,3
9158,http://t.co/B0gwkrBeDj,0,3,,1,0,3,,3
9159,Fidel,1,0,,1,1,0,,1
9160,Castro,8,0,,2,4,0,,8
9161,Jan,1,0,,1,1,0,,1
9162,Smuts,1,0,,1,1,0,,1
9163,Orbán,1,0,,1,1,0,,1
9164,Reservepulje,30,7,,1,30,7,,37
9165,https://t.co/4yWXJPZUfc,30,7,,1,30,7,,37
9166,https://t.co/OffhwqcPoZ,157,18,,1,157,18,,175
9167,Snik,0,0,,1,0,0,,0
9168,Sympatisk,2,2,,1,2,2,,4
9169,samfundsøkonomi,2,2,,1,2,2,,4
9170,TourDeFrance,24,3,,1,24,3,,27
9171,præg,152,20,,2,76,10,,172
9172,herlighed,24,3,,1,24,3,,27
9173,https://t.co/djG7vCIqdC,24,3,,1,24,3,,27
9174,udviklingspunkt,7,1,,1,7,1,,8
9175,kbh,0,1,,1,0,1,,1
9176,Folkeskolens,8,2,,1,8,2,,10
9177,helt,9,2,,2,4,1,,11
9178,https://t.co/FERtT8Q1v3,8,2,,1,8,2,,10
9179,Horribelt,12,0,,1,12,0,,12
9180,https://t.co/jFRYxh8fMo,12,0,,1,12,0,,12
9181,twitterhandle,1,0,,1,1,0,,1
9182,Tech-giganterne,12,4,,1,12,4,,16
9183,bagben,12,4,,1,12,4,,16
9184,Tønder,13,3,,2,6,2,,16
9185,Odsherred,0,2,,2,0,1,,2
9186,https://t.co/BhX3ztjFGV,0,1,,1,0,1,,1
9187,lyttertal,3,2,,1,3,2,,5
9188,https://t.co/u8xD9NA3L8,3,2,,1,3,2,,5
9189,gentagelse,1,1,,1,1,1,,2
9190,Udbytte,19,2,,1,19,2,,21
9191,afdeling,19,2,,1,19,2,,21
9192,udbytterefusion,19,2,,1,19,2,,21
9193,finanslovsforslag,83,14,,4,21,4,,97
9194,kontrolindsats,27,2,,2,14,1,,29
9195,Ulla,19,2,,1,19,2,,21
9196,Katja,76,10,,2,38,5,,86
9197,Bettina,19,2,,1,19,2,,21
9198,OK21,60,8,,2,30,4,,68
9199,Forhandlingerne,30,4,,1,30,4,,34
9200,overenskomst,110,13,,3,37,4,,123
9201,sættemøde,30,4,,2,15,2,,34
9202,https://t.co/zqbAlTtcng,30,4,,1,30,4,,34
9203,SR-regeringens,3,0,,1,3,0,,3
9204,fortsættelse,40,5,,2,20,2,,45
9205,udmøntning,3,0,,1,3,0,,3
9206,reservepuljen,3,0,,1,3,0,,3
9207,demensområdet,3,0,,1,3,0,,3
9208,kaffemaskine,0,0,,1,0,0,,0
9209,helligdom,0,0,,1,0,0,,0
9210,FortidensSynderViserSigFørstiNæsteGeneration,75,6,,1,75,6,,81
9211,samkørsel,3,0,,2,2,0,,3
9212,mormor,3,0,,1,3,0,,3
9213,Forfærdelige,25,1,,1,25,1,,26
9214,nyopført,0,0,,1,0,0,,0
9215,https://t.co/vxl1GNgBQD,4,3,,1,4,3,,7
9216,https://t.co/ThTS0spaAp,65,5,,1,65,5,,70
9217,folkeskoleelever,10,0,,1,10,0,,10
9218,spærregrænse,10,0,,1,10,0,,10
9219,Bjerregaard,22,3,,1,22,3,,25
9220,integrationspris,22,3,,1,22,3,,25
9221,https://t.co/K0S3gqC1qK,22,3,,1,22,3,,25
9222,https://t.co/fI1iWf9cPa,22,3,,1,22,3,,25
9223,DetDanmarkDuKender,3,1,,1,3,1,,4
9224,forbehold,5,0,,2,2,0,,5
9225,Foghs,4,0,,1,4,0,,4
9226,kontraktpolitik,4,0,,1,4,0,,4
9227,velfærdsaftalen,4,0,,1,4,0,,4
9228,faglært,12,14,,2,6,7,,26
9229,beskæftigelsesfrekvens,0,0,,1,0,0,,0
9230,Sundhedsstyrelsen,18,0,,1,18,0,,18
9231,station,34,4,,2,17,2,,38
9232,Metro,18,0,,1,18,0,,18
9233,Cityringen,18,0,,1,18,0,,18
9234,definere,1,0,,1,1,0,,1
9235,S-FT-medlemmer,1,0,,1,1,0,,1
9236,Kloge,87,6,,1,87,6,,93
9237,plejefamilie,87,6,,1,87,6,,93
9238,Ellen,8,1,,1,8,1,,9
9239,postsorterende,44,4,,1,44,4,,48
9240,Kristensen,44,4,,1,44,4,,48
9241,arkiv,44,4,,1,44,4,,48
9242,https://t.co/h5MP9MUqLa,44,4,,1,44,4,,48
9243,alting,3,0,,1,3,0,,3
9244,prioritere,23,5,,2,12,2,,28
9245,Scoop,0,3,,1,0,3,,3
9246,PET-,0,3,,1,0,3,,3
9247,FE-chefen,0,3,,1,0,3,,3
9248,Syrienskrigerne,0,3,,1,0,3,,3
9249,https://t.co/MIko0eb46i,0,3,,1,0,3,,3
9250,skrige,1,1,,1,1,1,,2
9251,Regler,7,6,,1,7,6,,13
9252,medicinhåndtering,7,6,,1,7,6,,13
9253,https://t.co/luR1BMgkO6,7,6,,1,7,6,,13
9254,fagforeningsvenner,5,1,,1,5,1,,6
9255,spm,6,1,,3,2,0,,7
9256,kloaksprog,1,0,,1,1,0,,1
9257,Konkurs,1,0,,1,1,0,,1
9258,Offentlige,33,6,,1,33,6,,39
9259,Arbejder,33,6,,1,33,6,,39
9260,Juul,36,6,,2,18,3,,42
9261,Rysensteen,33,6,,1,33,6,,39
9262,nyhedsbrev,33,6,,1,33,6,,39
9263,https://t.co/Uk6kogC6ys,33,6,,1,33,6,,39
9264,https://t.co/DCDyOUHWP6,33,6,,1,33,6,,39
9265,urigtig,5,2,,2,2,1,,7
9266,https://t.co/6kEJkkZHWp,5,2,,1,5,2,,7
9267,tørkeramt,263,31,,1,263,31,,294
9268,sår,312,39,,2,156,20,,351
9269,Ruth,3,1,,1,3,1,,4
9270,Pressemeddelelse,1,0,,1,1,0,,1
9271,Bosse,1,0,,1,1,0,,1
9272,Europabevægelse,1,0,,1,1,0,,1
9273,https://t.co/XniJuYrBvq,1,0,,1,1,0,,1
9274,https://t.co/NOktLnDprE,45,4,,1,45,4,,49
9275,Ældreministeren,27,3,,1,27,3,,30
9276,krigerisk,3,0,,1,3,0,,3
9277,ok18,3,0,,1,3,0,,3
9278,https://t.co/8bIVqbavrH,7,0,,1,7,0,,7
9279,Naturressourcer,0,0,,1,0,0,,0
9280,Agenda,80,9,,1,80,9,,89
9281,dump,80,9,,1,80,9,,89
9282,Arm,80,9,,1,80,9,,89
9283,trotz,80,9,,1,80,9,,89
9284,Arbeit,80,9,,1,80,9,,89
9285,Vestkredsen,11,4,,1,11,4,,15
9286,Camilla,22,8,,2,11,4,,30
9287,DSU,11,4,,2,6,2,,15
9288,særklasse,11,4,,1,11,4,,15
9289,https://t.co/zzheKyLtds,11,4,,1,11,4,,15
9290,https://t.co/oTb29RHLHp,36,8,,1,36,8,,44
9291,Twitter-dag,3,0,,1,3,0,,3
9292,Hovedstadens,35,8,,1,35,8,,43
9293,Letbane,35,8,,1,35,8,,43
9294,Økonomi,35,8,,1,35,8,,43
9295,Udbud,35,8,,1,35,8,,43
9296,Millioner,35,8,,1,35,8,,43
9297,Milliardvækst,35,8,,1,35,8,,43
9298,Omegnen,35,8,,1,35,8,,43
9299,https://t.co/36M4QjaS2,35,8,,1,35,8,,43
9300,https://t.co/w25UOwfz7n,35,8,,1,35,8,,43
9301,vildledning,9,4,,1,9,4,,13
9302,https://t.co/7f9heBFZkN,9,4,,1,9,4,,13
9303,ejendomsvurdering,2,0,,1,2,0,,2
9304,milliardstort,2,0,,1,2,0,,2
9305,orangefeeling,11,1,,1,11,1,,12
9306,Robyn,11,1,,1,11,1,,12
9307,dancingqueen,11,1,,1,11,1,,12
9308,https://t.co/U8FVBlIx1F,11,1,,1,11,1,,12
9309,voldscirklen,8,0,,1,8,0,,8
9310,Bispeengbuen,39,4,,1,39,4,,43
9311,investeringsplan,63,7,,2,32,4,,70
9312,Implementing,40,8,,1,40,8,,48
9313,SDGs,294,90,,5,59,18,,384
9314,sustainable,40,8,,1,40,8,,48
9315,future,2567,826,,3,856,275,,3393
9316,high,40,8,,1,40,8,,48
9317,Denmark,2940,936,,6,490,156,,3876
9318,This,40,8,,1,40,8,,48
9319,Sustainable,40,8,,1,40,8,,48
9320,Development,40,8,,1,40,8,,48
9321,ranks,40,8,,1,40,8,,48
9322,countries,77,21,,2,38,10,,98
9323,development,40,8,,1,40,8,,48
9324,sdgs,40,8,,1,40,8,,48
9325,globalgoals,40,8,,1,40,8,,48
9326,strækning,0,0,,1,0,0,,0
9327,strømsystem,0,0,,1,0,0,,0
9328,forårsmesse,5,1,,1,5,1,,6
9329,ForSønderjylland,5,1,,1,5,1,,6
9330,aggressiv,3,0,,1,3,0,,3
9331,lejestigningerne,3,0,,1,3,0,,3
9332,rundtur,7,3,,1,7,3,,10
9333,https://t.co/DuStRfl8i8,7,3,,1,7,3,,10
9334,mobiltelefon,50,7,,1,50,7,,57
9335,Uopmærksomhed,50,7,,1,50,7,,57
9336,hastighed,50,7,,2,25,4,,57
9337,dræber,50,7,,1,50,7,,57
9338,https://t.co/gep3wDWGI7,50,7,,1,50,7,,57
9339,fremlægge,11,0,,1,11,0,,11
9340,https://t.co/lTTxBQYgyS,11,0,,1,11,0,,11
9341,daglig,68,6,,3,23,2,,74
9342,Guder,0,0,,1,0,0,,0
9343,Ishockeylegenden,3,1,,1,3,1,,4
9344,Duus,3,1,,1,3,1,,4
9345,Ingeniøren,0,0,,1,0,0,,0
9346,Arriva,6,0,,2,3,0,,6
9347,troværdighed,33,9,,2,16,4,,42
9348,røre,41,3,,3,14,1,,44
9349,arbejderbevægelse,1,1,,1,1,1,,2
9350,maj-arrangementer,1,1,,1,1,1,,2
9351,talrig,1,1,,1,1,1,,2
9352,usand,10,1,,1,10,1,,11
9353,vedr.,18,2,,2,9,1,,20
9354,sundhedsplejerske,13,2,,2,6,1,,15
9355,Projektet,10,1,,1,10,1,,11
9356,september,37,1,,4,9,0,,38
9357,Investeringsbehovet,1,1,,1,1,1,,2
9358,ynglingssport,8,1,,1,8,1,,9
9359,S-R-SF,25,5,,2,12,2,,30
9360,ligelig,10,3,,1,10,3,,13
9361,nedskæringsplan,10,3,,1,10,3,,13
9362,trug,10,3,,1,10,3,,13
9363,surrealistisk,57,6,,2,28,3,,63
9364,medieforhandlinger,40,5,,1,40,5,,45
9365,Bocks,40,5,,1,40,5,,45
9366,https://t.co/pkkd9oT18J,40,5,,1,40,5,,45
9367,udklippe,30,6,,1,30,6,,36
9368,https://t.co/M6g0Yayf2A,30,6,,1,30,6,,36
9369,Well,50,2,,2,25,1,,52
9370,years,123,57,,2,62,28,,180
9371,later,4,2,,1,4,2,,6
9372,anti-Keynesian,4,2,,1,4,2,,6
9373,force,4,2,,1,4,2,,6
9374,been,25,19,,2,12,10,,44
9375,proved,4,2,,1,4,2,,6
9376,mistaken,4,2,,1,4,2,,6
9377,every,4,2,,1,4,2,,6
9378,single,4,2,,1,4,2,,6
9379,https://t.co/NQwl1TNUMY,4,2,,1,4,2,,6
9380,meningsdanner,2,0,,1,2,0,,2
9381,strukturel,2,0,,2,1,0,,2
9382,kulturændringer,2,0,,1,2,0,,2
9383,indvendig,2,0,,1,2,0,,2
9384,Selvf,1,0,,2,0,0,,1
9385,blir,104,0,,3,35,0,,104
9386,fleksjobordningen,4,1,,1,4,1,,5
9387,løntilskudsjob,4,1,,1,4,1,,5
9388,Parliamentary,1,0,,1,1,0,,1
9389,Intelligence-Security,1,0,,1,1,0,,1
9390,Forum,1,0,,1,1,0,,1
9391,Taskforce,1,0,,1,1,0,,1
9392,Terrorism,1,0,,1,1,0,,1
9393,Unconventional,1,0,,1,1,0,,1
9394,Warfare,1,0,,1,1,0,,1
9395,https://t.co/0ufRvQgKM6,2,2,,1,2,2,,4
9396,Sang,223,10,,1,223,10,,233
9397,Ung,223,10,,1,223,10,,233
9398,Blond,223,10,,1,223,10,,233
9399,Pige,223,10,,1,223,10,,233
9400,generalisering,223,10,,1,223,10,,233
9401,ThatEscalatedQuickly,223,10,,1,223,10,,233
9402,https://t.co/CjE3DbVmnL,223,10,,1,223,10,,233
9403,seminar,4,0,,1,4,0,,4
9404,kursus,47,7,,3,16,2,,54
9405,Heine,3,0,,1,3,0,,3
9406,Rollen,3,0,,1,3,0,,3
9407,FM18,2,0,,1,2,0,,2
9408,dkcivil,2,0,,1,2,0,,2
9409,solskinsø,2,0,,1,2,0,,2
9410,https://t.co/CPnNGjwJBp,2,0,,1,2,0,,2
9411,Staunings,73,15,,1,73,15,,88
9412,grav,73,15,,1,73,15,,88
9413,fredning,73,15,,1,73,15,,88
9414,sortregering,73,15,,1,73,15,,88
9415,https://t.co/WXk9dFwC5n,73,15,,1,73,15,,88
9416,Fru,17,1,,1,17,1,,18
9417,Vind,17,1,,1,17,1,,18
9418,jegsigertak,17,1,,1,17,1,,18
9419,https://t.co/K0AYgrEMkS,17,1,,1,17,1,,18
9420,Mailands,0,0,,1,0,0,,0
9421,disruption,0,0,,1,0,0,,0
9422,pct-point,0,0,,1,0,0,,0
9423,deltidsansatte,0,0,,1,0,0,,0
9424,lukkelov,0,0,,1,0,0,,0
9425,uskøn,16,2,,1,16,2,,18
9426,Kundby-pigen,16,2,,1,16,2,,18
9427,Brug,167,34,,5,33,7,,201
9428,drdokumentar,16,2,,1,16,2,,18
9429,mark-besøg,4,1,,1,4,1,,5
9430,EU-ministermøde,4,1,,1,4,1,,5
9431,Koblenz,4,1,,1,4,1,,5
9432,https://t.co/mRuaRyRkyB,4,1,,1,4,1,,5
9433,Skattely,26,3,,1,26,3,,29
9434,momssvindel,26,3,,1,26,3,,29
9435,Kreativiteten,26,3,,1,26,3,,29
9436,skattekontrol,26,3,,1,26,3,,29
9437,skattekontrolcentre,26,3,,1,26,3,,29
9438,https://t.co/vEW9WUW3yC,26,3,,1,26,3,,29
9439,sammens,7,1,,1,7,1,,8
9440,https://t.co/v3sI9F9n7r,7,1,,1,7,1,,8
9441,undtagelse,4,0,,1,4,0,,4
9442,Pio,6,0,,2,3,0,,6
9443,værdigrundlag,6,0,,2,3,0,,6
9444,10.del,3,0,,1,3,0,,3
9445,https://t.co/dOGIj0sIy7,3,0,,1,3,0,,3
9446,Billedet,8,1,,2,4,0,,9
9447,skurre,3,0,,1,3,0,,3
9448,bestilling,3,0,,1,3,0,,3
9449,sommerhus,3,0,,1,3,0,,3
9450,1divdk,2,0,,1,2,0,,2
9451,ejer,2,0,,1,2,0,,2
9452,nedrykkere,2,0,,1,2,0,,2
9453,sjællandsk,2,0,,1,2,0,,2
9454,domimans,2,0,,1,2,0,,2
9455,betyde,2,0,,1,2,0,,2
9456,Næverfan,2,0,,1,2,0,,2
9457,Mark,2,0,,1,2,0,,2
9458,Strudal,2,0,,1,2,0,,2
9459,Grimhøjimam,4,4,,1,4,4,,8
9460,http://t.co/pVxPDRhq58,4,4,,1,4,4,,8
9461,KV17-byråd,5,1,,1,5,1,,6
9462,Dhaqane,5,1,,1,5,1,,6
9463,skilsmissesystemet,35,1,,1,35,1,,36
9464,Familieretshuset,35,1,,1,35,1,,36
9465,https://t.co/iC5yY9vYoC,35,1,,1,35,1,,36
9466,topskattelettelsen,13,6,,1,13,6,,19
9467,udviklingsland,63,12,,2,32,6,,75
9468,Ellemann-Jensen,4,1,,3,1,0,,5
9469,skadelig,52,6,,2,26,3,,58
9470,https://t.co/rPG6cVJR3U,13,6,,1,13,6,,19
9471,forkøb,1,0,,1,1,0,,1
9472,udvikl.bistand,1,1,,1,1,1,,2
9473,https://t.co/Cema4WKJoU,3,1,,1,3,1,,4
9474,kam,80,7,,2,40,4,,87
9475,seniortilværelse,0,0,,1,0,0,,0
9476,mønt,11,0,,1,11,0,,11
9477,Smapsen,11,0,,1,11,0,,11
9478,priden,3,0,,1,3,0,,3
9479,Skjern,5,0,,2,2,0,,5
9480,https://t.co/hYOFklfsJN,3,0,,1,3,0,,3
9481,skolerenoveringer,0,0,,1,0,0,,0
9482,svjv,0,0,,1,0,0,,0
9483,milliardgrundkøb,0,0,,1,0,0,,0
9484,Pokalfinale,6,1,,1,6,1,,7
9485,knejter,6,1,,1,6,1,,7
9486,ping,6,1,,1,6,1,,7
9487,https://t.co/sFTfXjnlwj,6,1,,1,6,1,,7
9488,rejsecirkus,5,0,,2,2,0,,5
9489,gratis,2,0,,1,2,0,,2
9490,Centrum,9,2,,1,9,2,,11
9491,lyserødlørdag,9,2,,1,9,2,,11
9492,https://t.co/X0l3oJ0eeM,9,2,,1,9,2,,11
9493,Fantastic,1,1,,1,1,1,,2
9494,Remember,1,1,,1,1,1,,2
9495,sav,2528,819,,2,1264,410,,3347
9496,energy,1,1,,1,1,1,,2
9497,https://t.co/ryxbRkg0Ez,1,1,,1,1,1,,2
9498,BT's,36,15,,1,36,15,,51
9499,https://t.co/8eZ3rG53vJ,36,15,,1,36,15,,51
9500,Jøsses,26,3,,1,26,3,,29
9501,https://t.co/nBqvjT7PpF,26,3,,1,26,3,,29
9502,Sex,4,1,,1,4,1,,5
9503,børnepornotegnefilm,4,1,,1,4,1,,5
9504,virkelighedstro,4,1,,1,4,1,,5
9505,Børnesexdukker,4,1,,1,4,1,,5
9506,flankere,49,8,,1,49,8,,57
9507,påvirkning,49,8,,1,49,8,,57
9508,https://t.co/gM6IVpHnl9,49,8,,1,49,8,,57
9509,ParisAgreement,2528,819,,2,1264,410,,3347
9510,nato,1,1,,1,1,1,,2
9511,https://t.co/pQiYTRS1k9,1,1,,1,1,1,,2
9512,betalingsvilje,13,2,,1,13,2,,15
9513,Buræg,6,1,,1,6,1,,7
9514,JegKøberAldrigBuræg,6,1,,1,6,1,,7
9515,dyrevelfærd,31,5,,5,6,1,,36
9516,https://t.co/B3rHT1o1I1,6,1,,1,6,1,,7
9517,hovedejer,16,4,,1,16,4,,20
9518,Schmidts,7,0,,1,7,0,,7
9519,Udfordringerne,7,0,,1,7,0,,7
9520,socialdemokratismens,7,0,,1,7,0,,7
9521,moderskib,7,0,,1,7,0,,7
9522,styrkelse,11,2,,2,6,1,,13
9523,inkl,10,2,,1,10,2,,12
9524,https://t.co/ZDkkcMQnt6,10,2,,1,10,2,,12
9525,Abba,1,0,,1,1,0,,1
9526,kæmpestor,1,0,,1,1,0,,1
9527,verdenshit,1,0,,1,1,0,,1
9528,Queen,1,0,,1,1,0,,1
9529,band,1,0,,1,1,0,,1
9530,urørt,4,2,,1,4,2,,6
9531,ska,4,2,,1,4,2,,6
9532,bytte,4,2,,1,4,2,,6
9533,miljøudspil,4,2,,1,4,2,,6
9534,bestik,4,2,,1,4,2,,6
9535,pose,4,2,,1,4,2,,6
9536,plastikforurening,19,6,,2,10,3,,25
9537,Lenin,6,0,,1,6,0,,6
9538,pengetræ,6,0,,1,6,0,,6
9539,Alm,1,0,,1,1,0,,1
9540,bilafgift,1,0,,1,1,0,,1
9541,Lang,1,0,,1,1,0,,1
9542,sprog-nørdede,21,1,,1,21,1,,22
9543,storebror,21,1,,1,21,1,,22
9544,Flemming,21,1,,1,21,1,,22
9545,https://t.co/4Z0K3ctJnT,21,1,,1,21,1,,22
9546,https://t.co/hQyc19ot9,4,1,,1,4,1,,5
9547,forklaringsproblem,1,0,,1,1,0,,1
9548,ense,1,0,,1,1,0,,1
9549,Arg,1,0,,1,1,0,,1
9550,væst,1,0,,1,1,0,,1
9551,annelser,1,0,,1,1,0,,1
9552,påååå,1,0,,1,1,0,,1
9553,slogan,1,0,,1,1,0,,1
9554,https://t.co/coQ2OKA6re,3,0,,1,3,0,,3
9555,paradoks,13,1,,1,13,1,,14
9556,https://t.co/X0SpFpEwD9,13,1,,1,13,1,,14
9557,Fornemt,25,1,,1,25,1,,26
9558,ligestillingsordføreren,25,1,,1,25,1,,26
9559,https://t.co/Zj8PI08WQ6,25,1,,1,25,1,,26
9560,netværk,0,0,,1,0,0,,0
9561,fysik,0,0,,1,0,0,,0
9562,jep,0,0,,1,0,0,,0
9563,Rodet,0,0,,1,0,0,,0
9564,koordination,2,1,,1,2,1,,3
9565,lystig,2,1,,1,2,1,,3
9566,Fødevarestyrelsens,2,1,,1,2,1,,3
9567,minkfarm,2,1,,1,2,1,,3
9568,Socialtilsynet,15,6,,1,15,6,,21
9569,Tvind-opholdssted,15,6,,1,15,6,,21
9570,https://t.co/3l28q3C7vV,15,6,,1,15,6,,21
9571,Kvotekongerne,9,3,,1,9,3,,12
9572,https://t.co/IKJuv2NhoJ,9,3,,1,9,3,,12
9573,bandemedlem,19,1,,1,19,1,,20
9574,https://t.co/BhPzGYCbi4,19,1,,1,19,1,,20
9575,️Og,0,0,,1,0,0,,0
9576,Tommy,53,11,,1,53,11,,64
9577,Ahlers,53,11,,1,53,11,,64
9578,https://t.co/Glmhqzg8Yu,53,11,,1,53,11,,64
9579,https://t.co/B5dlXqeeQU,4,2,,1,4,2,,6
9580,http://t.co/m24Qa9px9P,0,1,,1,0,1,,1
9581,Imponerende,30,8,,2,15,4,,38
9582,medvind,17,2,,1,17,2,,19
9583,Blinker,13,5,,1,13,5,,18
9584,DF-boss,13,5,,1,13,5,,18
9585,fabrik,155,23,,3,52,8,,178
9586,energiforsyning,23,2,,1,23,2,,25
9587,https://t.co/L4YTpLAh9,23,2,,1,23,2,,25
9588,Erhvervslivets,15,2,,1,15,2,,17
9589,kompendium,15,2,,1,15,2,,17
9590,Dybkjær,52,1,,1,52,1,,53
9591,øjenkrog,52,1,,1,52,1,,53
9592,kunstig,15,3,,1,15,3,,18
9593,intelligens,15,3,,1,15,3,,18
9594,dkdigi,15,3,,1,15,3,,18
9595,https://t.co/3j2w1yUr5N,15,3,,1,15,3,,18
9596,Bandeproblemer,2,1,,1,2,1,,3
9597,eksplosiv,2,1,,1,2,1,,3
9598,selvtillid,14,1,,1,14,1,,15
9599,glidebane,2,0,,2,1,0,,2
9600,råde,26,0,,1,26,0,,26
9601,https://t.co/iXpxBQiv3r,26,0,,1,26,0,,26
9602,Full,16,2,,1,16,2,,18
9603,respect,16,2,,1,16,2,,18
9604,inspirational,16,2,,1,16,2,,18
9605,altruistic,16,2,,1,16,2,,18
9606,humanitarian,39,35,,2,20,18,,74
9607,UNHCR,16,2,,1,16,2,,18
9608,engaged,16,2,,1,16,2,,18
9609,https://t.co/yKfUEMO5uP,16,2,,1,16,2,,18
9610,skøn,19,3,,3,6,1,,22
9611,flaskehalsreform,0,0,,1,0,0,,0
9612,vækst-do,0,0,,1,0,0,,0
9613,visdom,40,6,,1,40,6,,46
9614,skak,40,6,,1,40,6,,46
9615,befrielsensøjeblik,40,6,,1,40,6,,46
9616,https://t.co/VZqWvZoRae,40,6,,1,40,6,,46
9617,klimaambitionerne,0,0,,1,0,0,,0
9618,Pressede,23,8,,1,23,8,,31
9619,inkompetent,23,8,,1,23,8,,31
9620,https://t.co/Cp86fA4A2d,23,8,,1,23,8,,31
9621,comeback,37,5,,1,37,5,,42
9622,tilbagegang,37,5,,1,37,5,,42
9623,forudsige,37,5,,1,37,5,,42
9624,regeringsforhandlingerne,37,5,,1,37,5,,42
9625,smålig,0,0,,1,0,0,,0
9626,tango,5,0,,1,5,0,,5
9627,tynde,5,0,,1,5,0,,5
9628,Kig,82,5,,1,82,5,,87
9629,https://t.co/DDs9zpi79y,82,5,,1,82,5,,87
9630,https://t.co/fLkvx0FLiU,8,7,,1,8,7,,15
9631,sving,0,0,,1,0,0,,0
9632,Helveg,187,16,,2,94,8,,203
9633,⁦Karen,9,0,,1,9,0,,9
9634,Melchior,9,0,,1,9,0,,9
9635,storhedsvanvid,9,0,,1,9,0,,9
9636,https://t.co/0HJUnLsJ5p,9,0,,1,9,0,,9
9637,fremskridt,5,0,,2,2,0,,5
9638,https://t.co/RLXptTx0AL,4,0,,1,4,0,,4
9639,Trump-lejren,9,2,,1,9,2,,11
9640,Karl,9,2,,1,9,2,,11
9641,Rove,9,2,,1,9,2,,11
9642,https://t.co/6oKfYS4vI9,9,2,,1,9,2,,11
9643,udenomssnak,4,1,,1,4,1,,5
9644,https://t.co/wBSTwHrRE3,4,1,,1,4,1,,5
9645,medieforlig,145,14,,2,72,7,,159
9646,kernevelfærden,3,1,,1,3,1,,4
9647,Brians,0,0,,1,0,0,,0
9648,påny,0,0,,1,0,0,,0
9649,Opkald,0,0,,1,0,0,,0
9650,ret,1,0,,1,1,0,,1
9651,hejhejhejehej-breaking,285,20,,1,285,20,,305
9652,haj,570,40,,2,285,20,,610
9653,Hello,285,20,,1,285,20,,305
9654,engelsk,288,20,,2,144,10,,308
9655,hajschool,285,20,,1,285,20,,305
9656,hejhejhejehej,285,20,,1,285,20,,305
9657,kronargumentet,5,4,,1,5,4,,9
9658,sløjfe,5,4,,1,5,4,,9
9659,indsigtsfuld,171,32,,1,171,32,,203
9660,udlægning,171,32,,1,171,32,,203
9661,https://t.co/lmGNJgTgyE,171,32,,1,171,32,,203
9662,JyllandsPosten,22,9,,1,22,9,,31
9663,Mali,22,9,,1,22,9,,31
9664,Indlægget,22,9,,1,22,9,,31
9665,Udenrigsminister,30,11,,2,15,6,,41
9666,Udviklingsminister,22,9,,1,22,9,,31
9667,https://t.co/SCXFNMMxAa,22,9,,1,22,9,,31
9668,uddannelsesloftet,0,0,,1,0,0,,0
9669,busreklamer,0,0,,1,0,0,,0
9670,tuberkulose,38,11,,1,38,11,,49
9671,malaria,38,11,,1,38,11,,49
9672,Globale,38,11,,1,38,11,,49
9673,Fond,38,11,,1,38,11,,49
9674,aids,44,12,,2,22,6,,56
9675,Lørdag,6,1,,1,6,1,,7
9676,Islev,6,1,,1,6,1,,7
9677,Torv,6,1,,1,6,1,,7
9678,Thulesen-Dahl,80,7,,1,80,7,,87
9679,Brøndby,0,0,,1,0,0,,0
9680,supplere,0,0,,1,0,0,,0
9681,koncept,0,0,,1,0,0,,0
9682,skuespiller,0,0,,1,0,0,,0
9683,hverfald,1,0,,1,1,0,,1
9684,påskehumør,1,0,,1,1,0,,1
9685,judaskys,1,0,,1,1,0,,1
9686,Babylon,1,0,,1,1,0,,1
9687,Berlin,1,0,,1,1,0,,1
9688,Tobias,0,0,,1,0,0,,0
9689,BJMF,5,0,,1,5,0,,5
9690,hooliganisme,5,0,,1,5,0,,5
9691,SL2017,21,5,,1,21,5,,26
9692,læreplads,22,5,,2,11,2,,27
9693,https://t.co/nlu2yPDw6l,21,5,,1,21,5,,26
9694,Rødt,0,0,,1,0,0,,0
9695,MDG,0,0,,1,0,0,,0
9696,Jonas,0,0,,1,0,0,,0
9697,Anlægsloven,21,3,,1,21,3,,24
9698,vestfynske,21,3,,1,21,3,,24
9699,flaskehals,21,3,,1,21,3,,24
9700,jernbanetrafik,21,3,,1,21,3,,24
9701,landsdel,21,3,,1,21,3,,24
9702,rejsetid,21,3,,1,21,3,,24
9703,https://t.co/kUuNmlF87,21,3,,1,21,3,,24
9704,minimum,50,8,,4,12,2,,58
9705,https://t.co/iCZqWBUXeV,2,0,,1,2,0,,2
9706,kød,162,19,,7,23,3,,181
9707,fortjeneste,0,0,,1,0,0,,0
9708,forældrebestyrelser,0,0,,1,0,0,,0
9709,medejerskab,0,0,,1,0,0,,0
9710,Nødvendigt,57,13,,1,57,13,,70
9711,skattenedsættelse,57,13,,1,57,13,,70
9712,Majestæt,458,13,,1,458,13,,471
9713,beskrivelse,458,13,,1,458,13,,471
9714,https://t.co/A6DqrfXFhN,458,13,,1,458,13,,471
9715,børnekonvention,78,10,,1,78,10,,88
9716,Meget,99,12,,2,50,6,,111
9717,opdragelse,78,10,,1,78,10,,88
9718,Indkalder,78,10,,1,78,10,,88
9719,aktør,78,10,,1,78,10,,88
9720,specialisere,2,1,,1,2,1,,3
9721,transportudvalg,36,11,,1,36,11,,47
9722,Bruxelles,148,31,,3,49,10,,179
9723,landevej,36,11,,1,36,11,,47
9724,lemfældig,13,3,,1,13,3,,16
9725,https://t.co/Ah9vf9tQMc,13,3,,1,13,3,,16
9726,sympatisk,3,0,,1,3,0,,3
9727,omgængelig,3,0,,1,3,0,,3
9728,syrlig,3,0,,1,3,0,,3
9729,Vanvittig,49,4,,1,49,4,,53
9730,Sandholm,6,3,,1,6,3,,9
9731,livsfare,6,3,,1,6,3,,9
9732,https://t.co/A4238nNuj6,6,3,,1,6,3,,9
9733,opsparingtilskattelettelser,2,2,,1,2,2,,4
9734,https://t.co/KOEdgzw3ov,6,1,,1,6,1,,7
9735,anstændighed,12,8,,2,6,4,,20
9736,sandsynliggøre,6,0,,1,6,0,,6
9737,uddannelsesmæssigt,6,0,,1,6,0,,6
9738,lærling,6,0,,1,6,0,,6
9739,sænkelse,6,0,,1,6,0,,6
9740,Venstre-folk,7,0,,1,7,0,,7
9741,Besynderligt,73,11,,2,36,6,,84
9742,politiskole,10,2,,2,5,1,,12
9743,https://t.co/bPZkPmody9,1,1,,1,1,1,,2
9744,https://t.co/xfc6Sm2yQT,29,0,,1,29,0,,29
9745,mikroplastik,15,4,,1,15,4,,19
9746,afføring,30,8,,2,15,4,,38
9747,genbrug,15,4,,2,8,2,,19
9748,Plastforbruget,15,4,,1,15,4,,19
9749,skurvogn,29,1,,2,14,0,,30
9750,skurvognsregulativet,15,0,,1,15,0,,15
9751,nørd,15,0,,1,15,0,,15
9752,https://t.co/6D5GzWwyxY,15,0,,1,15,0,,15
9753,lovlighed,1,0,,1,1,0,,1
9754,arbejdsret,1,0,,1,1,0,,1
9755,derhen,7,0,,2,4,0,,7
9756,sønderjysk,20,0,,1,20,0,,20
9757,arkitekt,20,0,,1,20,0,,20
9758,byggebranche,20,0,,1,20,0,,20
9759,koncentration,68,5,,1,68,5,,73
9760,fotografering,68,5,,1,68,5,,73
9761,nedbringe,141,13,,2,70,6,,154
9762,DK's,3,0,,1,3,0,,3
9763,Pressen,14,0,,1,14,0,,14
9764,vitamintilskud,1,2,,1,1,2,,3
9765,https://t.co/iIStvfh0Td,1,2,,1,1,2,,3
9766,Paula,0,0,,1,0,0,,0
9767,Mvh,12,2,,3,4,1,,14
9768,grønomstilling,0,0,,1,0,0,,0
9769,smykkeloven,11,6,,1,11,6,,17
9770,https://t.co/R19WSSehxC,11,6,,1,11,6,,17
9771,selvf,0,0,,1,0,0,,0
9772,fortov,0,0,,1,0,0,,0
9773,Honda,4,1,,1,4,1,,5
9774,Lamborghini,13,1,,2,6,0,,14
9775,https://t.co/sHtVByXSzW,17,7,,1,17,7,,24
9776,Tvivlen,25,8,,1,25,8,,33
9777,dreamteam,25,8,,1,25,8,,33
9778,fagforeningsvalg,11,0,,1,11,0,,11
9779,indiskutabel,11,0,,1,11,0,,11
9780,trivsel,28,11,,3,9,4,,39
9781,solnedgangsklausul,6,1,,1,6,1,,7
9782,nødlovgivning,6,1,,1,6,1,,7
9783,sundshedsudfordringerne,6,1,,1,6,1,,7
9784,Tjah,25,1,,1,25,1,,26
9785,typiskmandag,25,1,,1,25,1,,26
9786,https://t.co/xnAfWwwwlE,25,1,,1,25,1,,26
9787,spm.,0,0,,2,0,0,,0
9788,PSO'en,0,0,,1,0,0,,0
9789,energiproduktion,0,0,,1,0,0,,0
9790,markedspris,0,0,,1,0,0,,0
9791,produktionspris,0,0,,1,0,0,,0
9792,sosse,0,0,,1,0,0,,0
9793,https://t.co/qNiBPyUg73,0,0,,1,0,0,,0
9794,økologi,27,8,,3,9,3,,35
9795,https://t.co/eQEyqsnLfb,5,1,,1,5,1,,6
9796,COVID-19-laboratorie,49,11,,1,49,11,,60
9797,Vestdanmark,49,11,,1,49,11,,60
9798,Lasse,0,0,,1,0,0,,0
9799,hånd-i-hånd,0,0,,1,0,0,,0
9800,Industriens,0,0,,1,0,0,,0
9801,altan,4,0,,2,2,0,,4
9802,enhedslisten,2,0,,1,2,0,,2
9803,fastemåned,375,15,,1,375,15,,390
9804,covid-19,375,15,,1,375,15,,390
9805,Social,23,2,,1,23,2,,25
9806,Protokol,23,2,,1,23,2,,25
9807,S-partier,23,2,,1,23,2,,25
9808,fjor,23,2,,1,23,2,,25
9809,https://t.co/YQPZkMpN8W,3,3,,1,3,3,,6
9810,live,62,26,,5,12,5,,88
9811,Jarlovs,0,0,,1,0,0,,0
9812,glippe,0,0,,1,0,0,,0
9813,Ondskab,4,1,,1,4,1,,5
9814,https://t.co/ufaFSeeFhN,4,1,,1,4,1,,5
9815,Seje,19,1,,2,10,0,,20
9816,Klint,14,1,,1,14,1,,15
9817,https://t.co/RxGeOLVLyZ,14,1,,1,14,1,,15
9818,rækkefølge,3,0,,1,3,0,,3
9819,6’eren,3,0,,1,3,0,,3
9820,https://t.co/AXUrT1Ngw2,3,1,,1,3,1,,4
9821,ghettoisering,44,4,,1,44,4,,48
9822,kvarter,44,4,,1,44,4,,48
9823,tangent,6,0,,1,6,0,,6
9824,indlæggelse,0,0,,1,0,0,,0
9825,Ligestilling,0,0,,1,0,0,,0
9826,ligeværdig,0,0,,1,0,0,,0
9827,børnepenge,0,0,,1,0,0,,0
9828,overdødelighed,2,0,,1,2,0,,2
9829,Spanien,15,7,,2,8,4,,22
9830,skattepenge,24,2,,1,24,2,,26
9831,tiltænke,24,2,,1,24,2,,26
9832,privatskole,43,3,,3,14,1,,46
9833,boligreguleringslov,1,0,,1,1,0,,1
9834,memorere,1,0,,1,1,0,,1
9835,Løftebrud-anklage,3,1,,1,3,1,,4
9836,Come,4,2,,3,1,1,,6
9837,plat,16,1,,3,5,0,,17
9838,Sekretær,30,0,,1,30,0,,30
9839,ordinær,31,0,,2,16,0,,31
9840,pressesekretær,30,0,,1,30,0,,30
9841,https://t.co/Wbbk6Zuk3,30,0,,1,30,0,,30
9842,dagpengereformen,1,2,,1,1,2,,3
9843,indspark,63,10,,2,32,5,,73
9844,Smith,52,9,,1,52,9,,61
9845,https://t.co/uio9X73bfy,52,9,,1,52,9,,61
9846,House,1,0,,1,1,0,,1
9847,Cards,1,0,,1,1,0,,1
9848,https://t.co/wLCS7eSaF2,1,0,,1,1,0,,1
9849,NEJ,19,5,,3,6,2,,24
9850,Sara,6,0,,2,3,0,,6
9851,kronprinsparret,2,0,,1,2,0,,2
9852,alm,2,0,,1,2,0,,2
9853,rutefly,2,0,,1,2,0,,2
9854,Birkedahl,1,0,,1,1,0,,1
9855,creepy,1,0,,1,1,0,,1
9856,https://t.co/lMp4DQtNKR,1,0,,1,1,0,,1
9857,læselyst,1,0,,1,1,0,,1
9858,frue,1,0,,1,1,0,,1
9859,Morgenen,8,1,,1,8,1,,9
9860,Marianne,8,1,,1,8,1,,9
9861,udekørende,8,1,,1,8,1,,9
9862,ben-amputeret,8,1,,1,8,1,,9
9863,nyresyg,8,1,,1,8,1,,9
9864,Alting,47,6,,1,47,6,,53
9865,ffl18,47,6,,1,47,6,,53
9866,spritbilist,43,7,,1,43,7,,50
9867,spirituskørsel,43,7,,1,43,7,,50
9868,alkolås,43,7,,1,43,7,,50
9869,generhverve,43,7,,1,43,7,,50
9870,https://t.co/v2fKLo23GZ,43,7,,1,43,7,,50
9871,Sport,0,0,,2,0,0,,0
9872,Cola,13,10,,3,4,3,,23
9873,VUC,1,1,,1,1,1,,2
9874,erne,1,1,,1,1,1,,2
9875,mediekritik,1,1,,1,1,1,,2
9876,skinne,0,0,,1,0,0,,0
9877,ledelsesmæssig,21,4,,1,21,4,,25
9878,https://t.co/JNNNBe90tk,21,4,,1,21,4,,25
9879,genhør,0,0,,1,0,0,,0
9880,nørderiet,0,0,,1,0,0,,0
9881,ligestiling,70,17,,2,35,8,,87
9882,Kronprinsesse,13,1,,1,13,1,,14
9883,Mary,24,4,,2,12,2,,28
9884,Europaråd,27,3,,3,9,1,,30
9885,Parlamentariske,13,1,,1,13,1,,14
9886,Strasbourg,13,1,,1,13,1,,14
9887,https://t.co/WCeXA4bV1,13,1,,1,13,1,,14
9888,Nyttig,8,1,,1,8,1,,9
9889,smerte,8,1,,1,8,1,,9
9890,livsstil,8,1,,1,8,1,,9
9891,borgerlighed,10,1,,2,5,0,,11
9892,LGBTI,108,28,,4,27,7,,136
9893,Folkestyre,51,2,,2,26,1,,53
9894,kronprinsesse,213,23,,2,106,12,,236
9895,https://t.co/9hq3u47oHy,202,20,,1,202,20,,222
9896,druklegen,1,0,,1,1,0,,1
9897,Tomintoul,2,1,,1,2,1,,3
9898,Single,2,1,,1,2,1,,3
9899,speyside,2,1,,1,2,1,,3
9900,3-års,2,1,,1,2,1,,3
9901,baglågen,2,1,,1,2,1,,3
9902,Korsbæk,2,0,,1,2,0,,2
9903,Agnes,2,0,,1,2,0,,2
9904,cirkulær,2,0,,1,2,0,,2
9905,økonomi-typen,2,0,,1,2,0,,2
9906,centraliseringsøvelser,7,1,,1,7,1,,8
9907,https://t.co/NKAyyYJeeM,7,1,,1,7,1,,8
9908,Skattekontrollen,8,0,,1,8,0,,8
9909,skattekontrolcenter,8,0,,1,8,0,,8
9910,https://t.co/eHaLOBnXAw,8,0,,1,8,0,,8
9911,Gid,1,0,,2,0,0,,1
9912,Hold,32,1,,2,16,0,,33
9913,hånt,30,1,,1,30,1,,31
9914,Holocaust,95,2,,2,48,1,,97
9915,Sludder,3,0,,1,3,0,,3
9916,usund,244,19,,2,122,10,,263
9917,voksenudgaven,4,0,,1,4,0,,4
9918,tilbagetrækningsalder,0,0,,1,0,0,,0
9919,Uhyggelig,6,0,,1,6,0,,6
9920,identisk,1,1,,1,1,1,,2
9921,SR-regering,1,1,,1,1,1,,2
9922,https://t.co/55uT7xddsO,1,1,,1,1,1,,2
9923,Istanbuls,9,0,,1,9,0,,9
9924,Pride,9,0,,1,9,0,,9
9925,kender,0,0,,1,0,0,,0
9926,Landdistrikternes,21,8,,1,21,8,,29
9927,Fællesråd,21,8,,1,21,8,,29
9928,Budskabet,21,8,,1,21,8,,29
9929,bedrebalance,21,8,,1,21,8,,29
9930,https://t.co/k6qe30eOjB,21,8,,1,21,8,,29
9931,Bebrejdelsen,47,1,,1,47,1,,48
9932,https://t.co/NqrCWw2S01,47,1,,1,47,1,,48
9933,LGBTI-personer,8,1,,1,8,1,,9
9934,CPHPride,39,7,,2,20,4,,46
9935,Spolitik,8,1,,1,8,1,,9
9936,LGBT+,8,1,,1,8,1,,9
9937,https://t.co/TBzikbn84B,8,1,,1,8,1,,9
9938,Kristeriet,0,0,,1,0,0,,0
9939,verdenssport,0,0,,1,0,0,,0
9940,verdensdel,0,0,,1,0,0,,0
9941,turnering,0,0,,1,0,0,,0
9942,nemme,6,0,,2,3,0,,6
9943,udøver,0,0,,1,0,0,,0
9944,verdensstjerne,0,0,,1,0,0,,0
9945,golf,0,0,,1,0,0,,0
9946,karensperioden,1,0,,1,1,0,,1
9947,husleje,1,0,,1,1,0,,1
9948,pgrf,1,0,,1,1,0,,1
9949,coronatid,72,10,,1,72,10,,82
9950,FyrDitFyr,72,10,,1,72,10,,82
9951,binding,0,0,,1,0,0,,0
9952,kraftvarmekrav,0,0,,1,0,0,,0
9953,brændselsbindinger,0,0,,1,0,0,,0
9954,Sidstnævnte,0,0,,1,0,0,,0
9955,Velfærdsøkonomien,21,6,,1,21,6,,27
9956,specialeplanlægning,21,6,,1,21,6,,27
9957,Denrigtigehjælptilalle,21,6,,1,21,6,,27
9958,https://t.co/x7sDVWuyRv,21,6,,1,21,6,,27
9959,linie,11,0,,1,11,0,,11
9960,70%-målsætningen,11,0,,1,11,0,,11
9961,Saglighed,11,0,,1,11,0,,11
9962,Tilståelsessag,32,13,,1,32,13,,45
9963,klimaeffekt,47,14,,2,24,7,,61
9964,ilde,32,13,,1,32,13,,45
9965,klimarådet,32,13,,1,32,13,,45
9966,https://t.co/uvkDluNRgR,32,13,,1,32,13,,45
9967,kemi,87,4,,2,44,2,,91
9968,kosmetik,6,2,,1,6,2,,8
9969,valgspin,5,0,,1,5,0,,5
9970,nominating,204,30,,1,204,30,,234
9971,WearAMask,204,30,,1,204,30,,234
9972,challenge,204,30,,1,204,30,,234
9973,Danes,451,50,,2,226,25,,501
9974,obliged,204,30,,1,204,30,,234
9975,wear,204,30,,1,204,30,,234
9976,when,204,30,,1,204,30,,234
9977,using,267,41,,2,134,20,,308
9978,public,430,45,,4,108,11,,475
9979,fight,246,44,,2,123,22,,290
9980,https://t.co/Yglb4zQTwx,204,30,,1,204,30,,234
9981,Sammenhold,15,4,,1,15,4,,19
9982,taktik,61,8,,3,20,3,,69
9983,Æhhh,6,0,,1,6,0,,6
9984,skude,6,0,,1,6,0,,6
9985,rotte,6,0,,1,6,0,,6
9986,udtræde,6,0,,1,6,0,,6
9987,https://t.co/cu34UbbdKW,8,2,,1,8,2,,10
9988,erhvervsplan,2,2,,1,2,2,,4
9989,uambitiøs,2,2,,1,2,2,,4
9990,august,0,0,,1,0,0,,0
9991,udgangskontrol,0,0,,1,0,0,,0
9992,Grønt,2,2,,1,2,2,,4
9993,målestation,2,2,,1,2,2,,4
9994,giga-anlæg,0,1,,1,0,1,,1
9995,NoelGallagher,11,2,,1,11,2,,13
9996,forkertebror,11,2,,1,11,2,,13
9997,https://t.co/frzG1zTWpW,11,2,,1,11,2,,13
9998,arbejdsmarkedssituation,4,2,,1,4,2,,6
9999,italiensk,4,2,,1,4,2,,6
10000,bundlinie,1,0,,1,1,0,,1
10001,hane,68,10,,1,68,10,,78
10002,https://t.co/UUOzRHGQyu,68,10,,1,68,10,,78
10003,Europa-parlamentet,8,3,,1,8,3,,11
10004,opsang,8,3,,1,8,3,,11
10005,gennemsigtighed,8,3,,1,8,3,,11
10006,https://t.co/8a81rQrfF2,8,3,,1,8,3,,11
10007,skattesvindel,18,8,,2,9,4,,26
10008,fb-fænomen,0,0,,1,0,0,,0
10009,bemærkelsesværdig,0,0,,1,0,0,,0
10010,selvransagelse,7,0,,1,7,0,,7
10011,forbilledlig,492,15,,1,492,15,,507
10012,muslim-bashing,492,15,,1,492,15,,507
10013,Jugoslavien,3,0,,1,3,0,,3
10014,SFs,155,30,,3,52,10,,185
10015,ligestillingspris,130,23,,1,130,23,,153
10016,Ebba,130,23,,1,130,23,,153
10017,Strange,130,23,,1,130,23,,153
10018,Digitale,13,5,,1,13,5,,18
10019,NC3,13,5,,1,13,5,,18
10020,https://t.co/V97jxeMDeZ,13,5,,1,13,5,,18
10021,Cheføkonom,0,0,,1,0,0,,0
10022,lønning,0,0,,2,0,0,,0
10023,http://t.co/ZJDXp0KZPo,0,0,,1,0,0,,0
10024,Netop,0,0,,1,0,0,,0
10025,tegnedrengen,0,0,,1,0,0,,0
10026,Nemli,0,0,,1,0,0,,0
10027,Nysgerrig,1,0,,1,1,0,,1
10028,Kineserne,21,0,,1,21,0,,21
10029,Skamstøtten,21,0,,1,21,0,,21
10030,Glem,21,0,,1,21,0,,21
10031,kunstnerisk,21,0,,1,21,0,,21
10032,Galschiøt,21,0,,1,21,0,,21
10033,massakre,21,0,,1,21,0,,21
10034,politivold,42,7,,2,21,4,,49
10035,Hong,55,14,,3,18,5,,69
10036,Kong,55,14,,3,18,5,,69
10037,Ændringsforslaget,0,0,,1,0,0,,0
10038,https://t.co/2JBjjDToNt,24,6,,1,24,6,,30
10039,Why,3,4,,1,3,4,,7
10040,rigereudengrådighed,3,4,,1,3,4,,7
10041,https://t.co/oeb5qEMEUg,3,4,,1,3,4,,7
10042,Public,11,1,,1,11,1,,12
10043,Management,11,1,,1,11,1,,12
10044,Nedlæg,11,1,,1,11,1,,12
10045,Moderniseringsstyrelsen,11,1,,1,11,1,,12
10046,fordobling,1,0,,1,1,0,,1
10047,Sød,0,0,,1,0,0,,0
10048,pudsig,95,8,,1,95,8,,103
10049,rødgrøn,176,16,,2,88,8,,192
10050,Kriseregningen,28,4,,1,28,4,,32
10051,raport,5,0,,1,5,0,,5
10052,intension,0,0,,1,0,0,,0
10053,Kvindefodbold,24,0,,1,24,0,,24
10054,yndslingsfodboldholdet,24,0,,1,24,0,,24
10055,fordanmark,24,0,,1,24,0,,24
10056,kvindefodbold,24,0,,1,24,0,,24
10057,klimahandlingnu,24,0,,1,24,0,,24
10058,FUR,2,1,,1,2,1,,3
10059,ø-udvalget,2,1,,1,2,1,,3
10060,drømmeuddannelse,53,6,,1,53,6,,59
10061,adgangkvotienterne,53,6,,1,53,6,,59
10062,gangebonussen,53,6,,1,53,6,,59
10063,element,39,10,,1,39,10,,49
10064,klimapapir,39,10,,1,39,10,,49
10065,https://t.co/SRv2qyrUlC,86,3,,1,86,3,,89
10066,A4-analysen,1,0,,1,1,0,,1
10067,dynamik,0,0,,1,0,0,,0
10068,armod,0,0,,1,0,0,,0
10069,Wozniackis,4,0,,1,4,0,,4
10070,hovedvej,0,0,,1,0,0,,0
10071,erhvervsskole,59,7,,2,30,4,,66
10072,https://t.co/SziP5kN21f,54,7,,1,54,7,,61
10073,Statistik,138,13,,1,138,13,,151
10074,https://t.co/dIkQerKIKJ,19,4,,1,19,4,,23
10075,selvmordslinje,14,7,,1,14,7,,21
10076,nattetime,14,7,,1,14,7,,21
10077,http://t.co/VAMbkbcSL2,14,7,,1,14,7,,21
10078,Wuhu,165,22,,1,165,22,,187
10079,SU-reform,165,22,,1,165,22,,187
10080,SU-nedskæringer,165,22,,1,165,22,,187
10081,Mega,12,1,,2,6,0,,13
10082,https://t.co/3HMpLpn4iD,1,1,,1,1,1,,2
10083,exchange,2,0,,1,2,0,,2
10084,klimahandling,81,15,,2,40,8,,96
10085,klimaskeptikere,35,8,,1,35,8,,43
10086,StemGrønnest,35,8,,1,35,8,,43
10087,https://t.co/2MlI5K3K2J,35,8,,1,35,8,,43
10088,Selvmordsforebyggelse,11,3,,1,11,3,,14
10089,tværsekt,11,3,,1,11,3,,14
10090,b&amp;u,11,3,,1,11,3,,14
10091,medicinfri,11,3,,1,11,3,,14
10092,afd,11,3,,1,11,3,,14
10093,rar,1,0,,2,0,0,,1
10094,Arbejdsgivere,0,0,,1,0,0,,0
10095,uambitøse,0,0,,1,0,0,,0
10096,automatreaktion,0,0,,1,0,0,,0
10097,dyresex,1,0,,1,1,0,,1
10098,Deling,1,0,,1,1,0,,1
10099,Linse,1,0,,1,1,0,,1
10100,aaad,1,0,,1,1,0,,1
10101,smdk,1,0,,1,1,0,,1
10102,http://t.co/RW5svHZ2fD,1,0,,1,1,0,,1
10103,Kampagnen,0,0,,1,0,0,,0
10104,åbningstid,0,0,,1,0,0,,0
10105,planlægge,43,5,,3,14,2,,48
10106,fødeafdeling,0,0,,1,0,0,,0
10107,fitnesscenter,267,11,,1,267,11,,278
10108,valgfri,267,11,,1,267,11,,278
10109,Politisk-søndags-kommunikation,1,0,,1,1,0,,1
10110,liga,1,0,,1,1,0,,1
10111,sundhedsfarlig,4,0,,1,4,0,,4
10112,personalekapacitet,4,0,,1,4,0,,4
10113,ekse,6,0,,2,3,0,,6
10114,Opråb,3,4,,1,3,4,,7
10115,Risskov,3,4,,1,3,4,,7
10116,Hospital,3,4,,1,3,4,,7
10117,nÃ¸drÃ¥b,3,4,,1,3,4,,7
10118,åndsfrihed,58,7,,1,58,7,,65
10119,præst,58,7,,1,58,7,,65
10120,https://t.co/xngXICYMfB,58,7,,1,58,7,,65
10121,Sorry,2,0,,2,1,0,,2
10122,skolefravær,728,51,,2,364,26,,779
10123,cocktail,149,19,,1,149,19,,168
10124,https://t.co/vCWyAfuDLL,14,2,,1,14,2,,16
10125,https://t.co/dWp5DPOiR9,3,0,,1,3,0,,3
10126,Spørgsmål,5,0,,1,5,0,,5
10127,undrsøgelse,3,0,,1,3,0,,3
10128,https://t.co/i5PuXiZIu1,3,0,,1,3,0,,3
10129,vuggestue,409,12,,3,136,4,,421
10130,sprogstimulering,3,1,,1,3,1,,4
10131,defensiv,15,3,,2,8,2,,18
10132,Isolation,7,2,,1,7,2,,9
10133,https://t.co/XUjpfkfot1,7,2,,1,7,2,,9
10134,https://t.co/Z1Z9YCfXmK,83,8,,1,83,8,,91
10135,Wuhan,59,6,,2,30,3,,65
10136,https://t.co/i1WDNMmfwA,2,0,,1,2,0,,2
10137,smile,134,19,,1,134,19,,153
10138,Danmark?#dkpol,134,19,,1,134,19,,153
10139,Svindel,0,0,,1,0,0,,0
10140,ødelæggelse,0,0,,1,0,0,,0
10141,Falcks,6,0,,1,6,0,,6
10142,lobbyfirmaer,6,0,,1,6,0,,6
10143,flertpartistyre,12,0,,1,12,0,,12
10144,reklamebudskab,12,0,,1,12,0,,12
10145,Nykredit,12,0,,1,12,0,,12
10146,Pythons,6,0,,1,6,0,,6
10147,Meaning,6,0,,1,6,0,,6
10148,Heldigt,6,0,,1,6,0,,6
10149,børne,122,21,,1,122,21,,143
10150,kærlighed,164,25,,4,41,6,,189
10151,https://t.co/rkR1oT87yx,122,21,,1,122,21,,143
10152,Mailen,20,0,,1,20,0,,20
10153,rolig,20,0,,1,20,0,,20
10154,inddæmning,20,0,,1,20,0,,20
10155,afbødning,20,0,,1,20,0,,20
10156,skiturister,20,0,,1,20,0,,20
10157,tænke,4,3,,2,2,2,,7
10158,urealistisk,3,1,,1,3,1,,4
10159,Sørensen,7,10,,1,7,10,,17
10160,strube,7,10,,1,7,10,,17
10161,Krist,7,10,,1,7,10,,17
10162,Dagbl,7,10,,1,7,10,,17
10163,Skarp,7,10,,1,7,10,,17
10164,https://t.co/GWiw1fCS2j,7,10,,1,7,10,,17
10165,borgerinddragelse,42,4,,2,21,2,,46
10166,klimaborgerting,21,2,,1,21,2,,23
10167,https://t.co/ryd1fwigSE,21,2,,1,21,2,,23
10168,runde,171,10,,2,86,5,,181
10169,tech,142,10,,1,142,10,,152
10170,https://t.co/MmRgyLkHoy,142,10,,1,142,10,,152
10171,samvittighed,1,0,,1,1,0,,1
10172,stopprøve,1,0,,1,1,0,,1
10173,råbe,46,12,,3,15,4,,58
10174,spare,10,3,,1,10,3,,13
10175,MMF,10,3,,1,10,3,,13
10176,MFF,10,3,,1,10,3,,13
10177,DFU,1,0,,1,1,0,,1
10178,Chris,2,0,,2,1,0,,2
10179,https://t.co/ByaV70WBJd,1,0,,1,1,0,,1
10180,ordne,103,12,,1,103,12,,115
10181,https://t.co/vJUvF9we8,103,12,,1,103,12,,115
10182,broke,0,0,,1,0,0,,0
10183,Vejlegården,0,0,,1,0,0,,0
10184,statement,21,17,,2,10,8,,38
10185,kv17kolding,3,2,,1,3,2,,5
10186,https://t.co/CjBkXshXqn,3,2,,1,3,2,,5
10187,Kommuner,15,14,,1,15,14,,29
10188,https://t.co/zgqUIq5khK,15,14,,1,15,14,,29
10189,placering,1,0,,1,1,0,,1
10190,kandidatfeltet,1,0,,1,1,0,,1
10191,https://t.co/UXOZr0gItE,31,3,,1,31,3,,34
10192,målrette,7,4,,2,4,2,,11
10193,bundfradrag,1,0,,1,1,0,,1
10194,https://t.co/3SaKc08VyF,1,0,,1,1,0,,1
10195,hegn,49,7,,1,49,7,,56
10196,https://t.co/p9ruwm1d0A,49,7,,1,49,7,,56
10197,ClimateEmergency,49,9,,1,49,9,,58
10198,https://t.co/FCMY3HcbS2,49,9,,1,49,9,,58
10199,skolearbejde,50,5,,1,50,5,,55
10200,mistrivsel,654,41,,3,218,14,,695
10201,nødberedskab,77,27,,1,77,27,,104
10202,https://t.co/WsQZJCki4Y,77,27,,1,77,27,,104
10203,barselsfond,99,10,,1,99,10,,109
10204,barsle,99,10,,1,99,10,,109
10205,https://t.co/StJf4pK485,4,3,,1,4,3,,7
10206,rejseleder,2,0,,1,2,0,,2
10207,SFU's,2,0,,1,2,0,,2
10208,studietur,2,0,,1,2,0,,2
10209,USAvalg,2,0,,1,2,0,,2
10210,Espoo-konventionens,3,1,,1,3,1,,4
10211,procedure,3,1,,1,3,1,,4
10212,spør,6,1,,1,6,1,,7
10213,fyr,6,1,,1,6,1,,7
10214,panamapapers,6,1,,1,6,1,,7
10215,https://t.co/mRDt8UqqjF,6,1,,1,6,1,,7
10216,gårsdag,5,0,,1,5,0,,5
10217,profit,5,0,,1,5,0,,5
10218,rosenrød,4,0,,1,4,0,,4
10219,Adgang,4,0,,1,4,0,,4
10220,Abdel,4,0,,1,4,0,,4
10221,Thyras,4,0,,1,4,0,,4
10222,https://t.co/4mMzQic4pi,4,0,,1,4,0,,4
10223,ulighedskrisen,81,8,,1,81,8,,89
10224,https://t.co/HYuGB9JvZ9,81,8,,1,81,8,,89
10225,hjul,41,9,,1,41,9,,50
10226,https://t.co/8eb7q5toY7,41,9,,1,41,9,,50
10227,bil-aftalen,1,2,,1,1,2,,3
10228,ungdomskriminalitetsnævnet,32,3,,1,32,3,,35
10229,mental,32,3,,1,32,3,,35
10230,ophør,1,0,,1,1,0,,1
10231,domstolsprøvelse,4,0,,1,4,0,,4
10232,bæltefiksering,4,0,,1,4,0,,4
10233,Torturkomite,4,0,,1,4,0,,4
10234,https://t.co/wHvUj5aajU,4,0,,1,4,0,,4
10235,snappentin,1,0,,1,1,0,,1
10236,Ergoterapeuternes,3,0,,1,3,0,,3
10237,https://t.co/vTC2QhY6C4,3,0,,1,3,0,,3
10238,Plat,36,0,,1,36,0,,36
10239,Tryllepenge,39,12,,1,39,12,,51
10240,regionsråd,39,12,,1,39,12,,51
10241,bestyrelsesfora,39,12,,1,39,12,,51
10242,honorar,49,14,,2,24,7,,63
10243,modvægt,39,12,,1,39,12,,51
10244,https://t.co/0pcwt4GG1,39,12,,1,39,12,,51
10245,Præsidiet,2,1,,1,2,1,,3
10246,Kærlighed,18,0,,1,18,0,,18
10247,https://t.co/SJjHODlr9C,2,0,,1,2,0,,2
10248,objektiv,1,0,,1,1,0,,1
10249,kriterium,42,3,,5,8,1,,45
10250,udbudslov,1,0,,1,1,0,,1
10251,https://t.co/0Kve2LVgW7,1,0,,1,1,0,,1
10252,Tvingende,2,0,,1,2,0,,2
10253,https://t.co/yV5i1A1OY3,7,5,,1,7,5,,12
10254,afhjælpe,71,11,,1,71,11,,82
10255,LeaveNoOneBehind,71,11,,1,71,11,,82
10256,https://t.co/1oxrflMDn1,71,11,,1,71,11,,82
10257,https://t.co/FYf9sznebf,9,1,,1,9,1,,10
10258,lattergaspatroner,152,24,,1,152,24,,176
10259,Salg,152,24,,1,152,24,,176
10260,kiosk,152,24,,1,152,24,,176
10261,Lattergas,180,27,,2,90,14,,207
10262,livsfarlig,152,24,,1,152,24,,176
10263,https://t.co/Nrn9DsHLbV,152,24,,1,152,24,,176
10264,bagi,5,2,,1,5,2,,7
10265,lag,36,23,,1,36,23,,59
10266,overbelægning,36,23,,1,36,23,,59
10267,Bilens,0,0,,1,0,0,,0
10268,indretning,192,13,,2,96,6,,205
10269,chauffør,9,2,,2,4,1,,11
10270,Burger,13,10,,1,13,10,,23
10271,Coca,13,10,,1,13,10,,23
10272,skat.dk,13,10,,1,13,10,,23
10273,0kr,13,10,,1,13,10,,23
10274,velfærdskroner,36,15,,1,36,15,,51
10275,Private,36,15,,1,36,15,,51
10276,husholdningskasse,36,15,,1,36,15,,51
10277,velfærdsindsatser,36,15,,1,36,15,,51
10278,https://t.co/kXegUnUpSI,36,15,,1,36,15,,51
10279,efterspg,0,0,,1,0,0,,0
10280,Klimakrisen,0,0,,1,0,0,,0
10281,Ringkøbing,3,1,,1,3,1,,4
10282,https://t.co/jGfhiKtH6e,3,1,,1,3,1,,4
10283,overflødig,53,7,,1,53,7,,60
10284,tosse,53,7,,1,53,7,,60
10285,Beløbet,53,7,,1,53,7,,60
10286,idioti,171,18,,2,86,9,,189
10287,Højrefløjens,53,7,,1,53,7,,60
10288,vejplan,53,7,,1,53,7,,60
10289,regeringsmagt,54,9,,2,27,4,,63
10290,bestikkelse,53,7,,1,53,7,,60
10291,Casper,15,2,,1,15,2,,17
10292,https://t.co/D3jruxbaka,15,2,,1,15,2,,17
10293,sflm16#sammen,3,1,,1,3,1,,4
10294,https://t.co/3goZYZGehp,3,1,,1,3,1,,4
10295,udfasning,3,0,,3,1,0,,3
10296,pludselig,2,0,,1,2,0,,2
10297,masseaflivning,2,0,,1,2,0,,2
10298,Følgegruppen,5,2,,1,5,2,,7
10299,skelne,1,0,,1,1,0,,1
10300,baglinje,134,0,,1,134,0,,134
10301,doorstep,134,0,,1,134,0,,134
10302,tillykke-beskederne,134,0,,1,134,0,,134
10303,https://t.co/AexBd1vPRc,134,0,,1,134,0,,134
10304,vaccinere,97,13,,1,97,13,,110
10305,minkpels,97,13,,1,97,13,,110
10306,https://t.co/o2RVgt5lxM,97,13,,1,97,13,,110
10307,Besparelsen,307,52,,1,307,52,,359
10308,massefyring,307,52,,1,307,52,,359
10309,yndlingsprogrammer,307,52,,1,307,52,,359
10310,Ramasjang,307,52,,1,307,52,,359
10311,Ultra,308,53,,2,154,26,,361
10312,sparekniv,307,52,,1,307,52,,359
10313,fandeme,307,52,,1,307,52,,359
10314,Menneskerettighedsråd,121,25,,1,121,25,,146
10315,advare,121,25,,1,121,25,,146
10316,deal,246,54,,2,123,27,,300
10317,greennewdeal,121,25,,1,121,25,,146
10318,Folkets,105,12,,1,105,12,,117
10319,FridaysForFuture,105,12,,1,105,12,,117
10320,pressechef,2,0,,1,2,0,,2
10321,skulder,2,0,,1,2,0,,2
10322,Trumpets,46,7,,1,46,7,,53
10323,ClimateAction,46,7,,1,46,7,,53
10324,Oooookay,2,0,,1,2,0,,2
10325,Hjælpen,2,1,,1,2,1,,3
10326,hjerneskadet,2,1,,1,2,1,,3
10327,halte,2,1,,1,2,1,,3
10328,⁦@Spolitik⁩,123,24,,1,123,24,,147
10329,Klimapartnerskabet,123,24,,1,123,24,,147
10330,skygge,123,24,,2,62,12,,147
10331,klimamålsætning,123,24,,1,123,24,,147
10332,https://t.co/wnuWqCYky1,123,24,,1,123,24,,147
10333,jødehader,0,0,,1,0,0,,0
10334,enlig,144,32,,1,144,32,,176
10335,skoletandlæge,144,32,,1,144,32,,176
10336,Nærvær,144,32,,1,144,32,,176
10337,https://t.co/dQvDNRMOgZ,144,32,,1,144,32,,176
10338,omprioriteringsbidraget,34,12,,1,34,12,,46
10339,udflytning,8,0,,2,4,0,,8
10340,ÅOP-loft,5,0,,1,5,0,,5
10341,Forbrugerrådet,5,0,,1,5,0,,5
10342,kyokushin,1,0,,1,1,0,,1
10343,kaste,3,2,,1,3,2,,5
10344,tryllepenge,3,2,,1,3,2,,5
10345,arbejdsdeling,11,1,,1,11,1,,12
10346,hasteloven,1,0,,1,1,0,,1
10347,Rædselsfuldt,230,11,,1,230,11,,241
10348,nederdrægtig,230,11,,2,115,6,,241
10349,levevis,230,11,,1,230,11,,241
10350,Uber,0,0,,2,0,0,,0
10351,Unødvendigt,4,0,,1,4,0,,4
10352,Togpersonalet,4,0,,1,4,0,,4
10353,børnecheck,579,32,,1,579,32,,611
10354,kønsidentitet,2,0,,1,2,0,,2
10355,kønsudtryk,2,0,,1,2,0,,2
10356,mobilisering,59,8,,1,59,8,,67
10357,ejendomsspekulant,217,11,,1,217,11,,228
10358,storby,217,11,,1,217,11,,228
10359,https://t.co/iZVMYRosw0,217,11,,1,217,11,,228
10360,planet,66,13,,2,33,6,,79
10361,sværdslag,40,9,,1,40,9,,49
10362,klimapolitik,86,18,,3,29,6,,104
10363,strømpil,40,9,,1,40,9,,49
10364,2025-mål,40,9,,1,40,9,,49
10365,https://t.co/dya6QjMuuG,40,9,,1,40,9,,49
10366,kærkommen,25,3,,1,25,3,,28
10367,Skrot,25,3,,1,25,3,,28
10368,https://t.co/LYVnwScszv,25,3,,1,25,3,,28
10369,topdirektørers,6,0,,1,6,0,,6
10370,aflønning,6,0,,1,6,0,,6
10371,OK-forhandlinger,6,0,,1,6,0,,6
10372,http://t.co/qygZatDvLq,3,0,,1,3,0,,3
10373,Serdal,3,0,,1,3,0,,3
10374,Stats-,0,0,,1,0,0,,0
10375,kommunehospital,0,0,,1,0,0,,0
10376,valgkampspenge,0,0,,1,0,0,,0
10377,flodbølge,16,1,,1,16,1,,17
10378,ELs,3,1,,1,3,1,,4
10379,Amen,1,0,,1,1,0,,1
10380,statsborgerskabssag,0,2,,1,0,2,,2
10381,http://t.co/p6uAzrLCzs,0,2,,1,0,2,,2
10382,fjerne,4,1,,1,4,1,,5
10383,psykologhjælp,89,13,,2,44,6,,102
10384,https://t.co/Xgcwq4USjY,4,1,,1,4,1,,5
10385,dkklkma,72,9,,1,72,9,,81
10386,valgrap,128,24,,2,64,12,,152
10387,views,64,12,,1,64,12,,76
10388,Power-to-X,75,5,,1,75,5,,80
10389,jydsk,75,5,,1,75,5,,80
10390,https://t.co/iJ4GRg2KYr,75,5,,1,75,5,,80
10391,klimadiskussionerne,70,5,,1,70,5,,75
10392,drivhusgasreduktioner,70,5,,1,70,5,,75
10393,gasse,63,6,,2,32,3,,69
10394,KeepItInTheGround,47,5,,1,47,5,,52
10395,stopoliejagt,47,5,,1,47,5,,52
10396,https://t.co/5vkCONQkSy,47,5,,1,47,5,,52
10397,sænke,0,0,,1,0,0,,0
10398,infrastuktur,0,0,,1,0,0,,0
10399,taken,0,0,,1,0,0,,0
10400,Køln,0,0,,1,0,0,,0
10401,Sovjet,2,0,,2,1,0,,2
10402,invasion,2,0,,1,2,0,,2
10403,afstandstagen,2,0,,1,2,0,,2
10404,fortale,2,0,,1,2,0,,2
10405,døgn,25,11,,2,12,6,,36
10406,dyster,5,7,,1,5,7,,12
10407,selvdestruktiv,5,7,,1,5,7,,12
10408,http://t.co/RXbNELtJ1,5,7,,1,5,7,,12
10409,Konstruktivt,30,6,,1,30,6,,36
10410,havvindmølle,30,6,,1,30,6,,36
10411,energi-ø,30,6,,1,30,6,,36
10412,https://t.co/ueMfvRFt5o,30,6,,1,30,6,,36
10413,Tanken,0,0,,1,0,0,,0
10414,https://t.co/XFGNqn8sI9,13,0,,1,13,0,,13
10415,Hyggeligt,2,0,,1,2,0,,2
10416,idealistisk,0,0,,1,0,0,,0
10417,bryst,0,0,,1,0,0,,0
10418,guldrandet,0,0,,1,0,0,,0
10419,Gennemsnit,3,3,,1,3,3,,6
10420,Fanden,3,3,,1,3,3,,6
10421,kortudd,3,3,,1,3,3,,6
10422,fremhæve,12,6,,1,12,6,,18
10423,defacto,12,6,,1,12,6,,18
10424,HIV,6,1,,1,6,1,,7
10425,Aids,6,1,,1,6,1,,7
10426,psykofarmakum,4,4,,1,4,4,,8
10427,Lavt,118,0,,1,118,0,,118
10428,https://t.co/86xP0UoJrS,4,2,,1,4,2,,6
10429,Kvinder,121,14,,2,60,7,,135
10430,fucking,902,29,,2,451,14,,931
10431,faktisk,15,3,,1,15,3,,18
10432,https://t.co/YLhZONE248,4,1,,1,4,1,,5
10433,Nørde-alarm,147,12,,1,147,12,,159
10434,CO2-fortrængningskrav,147,12,,1,147,12,,159
10435,brændstof,312,28,,4,78,7,,340
10436,Palme,147,12,,1,147,12,,159
10437,sojaolie,147,12,,1,147,12,,159
10438,interessere,0,0,,1,0,0,,0
10439,lånemulighed,0,0,,1,0,0,,0
10440,lønarbejder,6,0,,1,6,0,,6
10441,minoritet,55,7,,4,14,2,,62
10442,irreversibel,14,0,,1,14,0,,14
10443,slagsmål,2,0,,1,2,0,,2
10444,Europa-Kommissionen,2,0,,1,2,0,,2
10445,mistrives,34,1,,1,34,1,,35
10446,biodiversitet,171,31,,6,28,5,,202
10447,https://t.co/fc0vSxUnqQ,66,13,,1,66,13,,79
10448,Nederlag,10,1,,1,10,1,,11
10449,https://t.co/uDAFkYOsvd,10,1,,1,10,1,,11
10450,stalking,23,6,,1,23,6,,29
10451,politiforlig,23,6,,1,23,6,,29
10452,grønskolling,6,0,,1,6,0,,6
10453,https://t.co/wV4buQUdHH,74,9,,1,74,9,,83
10454,selektion,0,0,,1,0,0,,0
10455,Grønner,6,0,,1,6,0,,6
10456,https://t.co/zDjPqRCSj9,6,0,,1,6,0,,6
10457,Gud,6,1,,1,6,1,,7
10458,Kons.,6,1,,1,6,1,,7
10459,Religionsfrihed,6,1,,1,6,1,,7
10460,vikar,6,1,,1,6,1,,7
10461,spændetrøje,2,0,,1,2,0,,2
10462,kltop19,2,0,,1,2,0,,2
10463,https://t.co/H5mUWu8IkA,2,0,,1,2,0,,2
10464,aftes,54,6,,1,54,6,,60
10465,klimalovnu,54,6,,1,54,6,,60
10466,kag,16,1,,1,16,1,,17
10467,https://t.co/gFnWY0i09U,16,1,,1,16,1,,17
10468,sflm18,16,1,,1,16,1,,17
10469,SFere,16,1,,1,16,1,,17
10470,updated,16,1,,1,16,1,,17
10471,https://t.co/VgWRPdRl2,16,1,,1,16,1,,17
10472,Rigtigt,6,4,,2,3,2,,10
10473,slide,0,0,,1,0,0,,0
10474,fornyelse,0,0,,1,0,0,,0
10475,helsehjemmeside,0,0,,1,0,0,,0
10476,privatperson,10,2,,2,5,1,,12
10477,c-vitamin,0,0,,1,0,0,,0
10478,successen,0,0,,1,0,0,,0
10479,finanslovsforhandling,6,0,,1,6,0,,6
10480,Amazonas,53,12,,1,53,12,,65
10481,ansvarsløs,53,12,,1,53,12,,65
10482,https://t.co/44FANGdKie,53,12,,1,53,12,,65
10483,institutionel,56,13,,1,56,13,,69
10484,https://t.co/iWVd2O0GWW,56,13,,1,56,13,,69
10485,brobygning,3,0,,1,3,0,,3
10486,https://t.co/EePBmNH8zr,29,2,,1,29,2,,31
10487,Aajj,1,0,,1,1,0,,1
10488,prøvetagning,0,0,,1,0,0,,0
10489,Byggeri,12,15,,2,6,8,,27
10490,læretid,12,14,,1,12,14,,26
10491,håndtrykstravet,118,11,,1,118,11,,129
10492,symbolpolitisk,118,11,,1,118,11,,129
10493,lævn,118,11,,1,118,11,,129
10494,Støjberg-tiden,118,11,,1,118,11,,129
10495,blodtryk,0,0,,2,0,0,,0
10496,https://t.co/4lLPTcxWsR,28,6,,1,28,6,,34
10497,fordeling,4,0,,1,4,0,,4
10498,sflm17,18,4,,1,18,4,,22
10499,https://t.co/6i1ny7Pmnm,18,4,,1,18,4,,22
10500,regneark,6,4,,1,6,4,,10
10501,https://t.co/xKvp2DlMaT,6,4,,1,6,4,,10
10502,student,110,9,,1,110,9,,119
10503,rust,110,9,,1,110,9,,119
10504,Studievalg,110,9,,1,110,9,,119
10505,tage,110,9,,1,110,9,,119
10506,https://t.co/nccRM3dWzs,44,12,,1,44,12,,56
10507,https://t.co/GxmdZa5c4S,47,1,,1,47,1,,48
10508,FOAs,3,0,,1,3,0,,3
10509,afdækning,3,0,,1,3,0,,3
10510,bosted,3,0,,1,3,0,,3
10511,https://t.co/wnouFbFg8d,3,0,,1,3,0,,3
10512,https://t.co/50ztKv38g6,37,5,,1,37,5,,42
10513,tæsk,0,0,,1,0,0,,0
10514,bøllebank,0,0,,1,0,0,,0
10515,Paradokser,2,1,,1,2,1,,3
10516,https://t.co/nzcXKhRf0X,2,1,,1,2,1,,3
10517,Oster,1,0,,1,1,0,,1
10518,https://t.co/eFnM18kUpU,5,2,,1,5,2,,7
10519,ydelseskommissionen,3,0,,1,3,0,,3
10520,https://t.co/ZEE8c21166,88,20,,1,88,20,,108
10521,Togfonden,33,9,,1,33,9,,42
10522,sidespor,33,9,,1,33,9,,42
10523,KÆMPE,16,4,,1,16,4,,20
10524,sundhedvæsenet,16,4,,1,16,4,,20
10525,demokratietsaften,16,4,,1,16,4,,20
10526,procentvis,2,0,,1,2,0,,2
10527,aldersgruppe,2,0,,1,2,0,,2
10528,Friskolerne,132,16,,1,132,16,,148
10529,uddannelsestradition,132,16,,1,132,16,,148
10530,grundskole,132,16,,1,132,16,,148
10531,belønne,135,16,,2,68,8,,151
10532,Brian,9,0,,1,9,0,,9
10533,Mikkelsen,14,1,,2,7,0,,15
10534,Yvonne,9,0,,1,9,0,,9
10535,https://t.co/rSAEvcgJAQ,5,0,,1,5,0,,5
10536,https://t.co/tuIncYNzzf,19,2,,1,19,2,,21
10537,hylde,215,21,,1,215,21,,236
10538,mønsterbrydere,215,21,,1,215,21,,236
10539,mønstre,215,21,,1,215,21,,236
10540,https://t.co/QcHqCQEYwI,215,21,,1,215,21,,236
10541,Kødproduktionen,5,1,,1,5,1,,6
10542,gkgreen,5,1,,1,5,1,,6
10543,https://t.co/laTcwbon2x,5,1,,1,5,1,,6
10544,https://t.co/D1hJBfFfcn,0,0,,1,0,0,,0
10545,Bliv,0,0,,1,0,0,,0
10546,pba,0,0,,1,0,0,,0
10547,etnicitet,0,0,,1,0,0,,0
10548,klimakampen,259,21,,1,259,21,,280
10549,EGP's,4,2,,1,4,2,,6
10550,fmd.,4,2,,1,4,2,,6
10551,markedskritisk,4,2,,1,4,2,,6
10552,venstregrøn,4,2,,1,4,2,,6
10553,https://t.co/o9vpJzKhs5,4,2,,1,4,2,,6
10554,indvandrerkritiske,578,38,,1,578,38,,616
10555,Øøhh,578,38,,1,578,38,,616
10556,karseklippet,578,38,,1,578,38,,616
10557,fordomsfuld,578,38,,1,578,38,,616
10558,hadefuld,588,40,,2,294,20,,628
10559,akvarium,578,38,,1,578,38,,616
10560,https://t.co/vt2Rxb4tgi,15,4,,1,15,4,,19
10561,modtagecenter,16,4,,2,8,2,,20
10562,10-års,5,2,,1,5,2,,7
10563,religionsfrihed,5,2,,1,5,2,,7
10564,religiondk,5,2,,1,5,2,,7
10565,personalemangel,9,2,,1,9,2,,11
10566,Kriminalforsorgen,9,2,,1,9,2,,11
10567,sydjysk,2,1,,1,2,1,,3
10568,retsvæsen,1,0,,1,1,0,,1
10569,udskrift,3,0,,1,3,0,,3
10570,klimaungeråd,1,1,,1,1,1,,2
10571,klimastrejker,1,1,,1,1,1,,2
10572,stordriftsfordel,59,2,,1,59,2,,61
10573,bespare,59,2,,1,59,2,,61
10574,smådriftsfordele,59,2,,1,59,2,,61
10575,orlovssituationer,3,0,,1,3,0,,3
10576,orlov,130,13,,3,43,4,,143
10577,relation,3,0,,1,3,0,,3
10578,folketingsarbejde,3,0,,1,3,0,,3
10579,Paris-aftalen,25,4,,2,12,2,,29
10580,eu-budgettet,8,0,,1,8,0,,8
10581,forhandlingsmandat,8,0,,1,8,0,,8
10582,smittestigning,3,2,,1,3,2,,5
10583,smittekæde,3,2,,1,3,2,,5
10584,Virksomheder,3,2,,1,3,2,,5
10585,Medarbejdere,3,2,,1,3,2,,5
10586,https://t.co/VK9FDicNvF,3,2,,1,3,2,,5
10587,kanal,2,0,,1,2,0,,2
10588,krigskasse,52,6,,1,52,6,,58
10589,https://t.co/V7bYvKCOZj,52,6,,1,52,6,,58
10590,Lizette,2,1,,1,2,1,,3
10591,https://t.co/od3Zf9CTta,2,1,,1,2,1,,3
10592,grønnecheck,68,10,,1,68,10,,78
10593,Redskabet,15,1,,1,15,1,,16
10594,fossilbiler,43,7,,2,22,4,,50
10595,kræftramt,83,8,,1,83,8,,91
10596,https://t.co/BuyC4zicpC,83,8,,1,83,8,,91
10597,kystkommune,6,4,,1,6,4,,10
10598,svensker,6,4,,1,6,4,,10
10599,sandsugning,12,8,,2,6,4,,20
10600,finansieringsforslag,1,0,,1,1,0,,1
10601,dræne,891,28,,1,891,28,,919
10602,Trump-impersonater,891,28,,1,891,28,,919
10603,naziuniform,891,28,,1,891,28,,919
10604,fuldstændig,1,0,,1,1,0,,1
10605,Partierne,1,0,,1,1,0,,1
10606,Hey,15,1,,2,8,0,,16
10607,ultravalg,1,1,,1,1,1,,2
10608,plastforurening,12,4,,1,12,4,,16
10609,https://t.co/QP9yxUtVjD,12,4,,1,12,4,,16
10610,borgerting,69,2,,1,69,2,,71
10611,NejBetyderNej,0,0,,1,0,0,,0
10612,https://t.co/JmF1sig8tC,0,0,,1,0,0,,0
10613,Snittene,2,0,,1,2,0,,2
10614,Gellerup,0,0,,1,0,0,,0
10615,SFULM15,1,0,,1,1,0,,1
10616,https://t.co/5TpD069Y8h,1,0,,1,1,0,,1
10617,https://t.co/qd3DpuzrIm,6,2,,1,6,2,,8
10618,fremgang,5,0,,1,5,0,,5
10619,Kraftfuld,25,4,,1,25,4,,29
10620,Klima-,25,4,,1,25,4,,29
10621,biodiversitetskrisens,25,4,,1,25,4,,29
10622,uoverskuelig,25,4,,1,25,4,,29
10623,Målet,1,0,,1,1,0,,1
10624,Langballe,4,1,,1,4,1,,5
10625,drdeadline,4,1,,1,4,1,,5
10626,Boligaftalen,0,0,,1,0,0,,0
10627,hovedregel,0,0,,1,0,0,,0
10628,svie,21,3,,1,21,3,,24
10629,lobbyist,21,3,,1,21,3,,24
10630,Falck,42,6,,2,21,3,,48
10631,Bios,42,6,,2,21,3,,48
10632,harme,46,8,,1,46,8,,54
10633,https://t.co/5mPg1uzTqS,46,8,,1,46,8,,54
10634,Ensidigt,6,0,,1,6,0,,6
10635,ønskeseddel,6,0,,1,6,0,,6
10636,https://t.co/8zDGNDS3di,6,0,,1,6,0,,6
10637,lække,1,0,,1,1,0,,1
10638,Udgangsforbud,10,3,,1,10,3,,13
10639,bølle,10,3,,1,10,3,,13
10640,Fil,0,1,,1,0,1,,1
10641,neg,3,0,,1,3,0,,3
10642,forskningsreserve,3,0,,1,3,0,,3
10643,kerneopgave,0,0,,1,0,0,,0
10644,haveaffald,0,0,,1,0,0,,0
10645,genbrugsplads,0,0,,1,0,0,,0
10646,https://t.co/UfRpCYyykk,90,4,,1,90,4,,94
10647,Pjat,0,0,,1,0,0,,0
10648,underholdningsværdi,40,5,,1,40,5,,45
10649,lovgiver,1,0,,1,1,0,,1
10650,Højesteret,1,0,,1,1,0,,1
10651,Skattestyrelsen,2,0,,1,2,0,,2
10652,Små,9,2,,1,9,2,,11
10653,https://t.co/R7CQTlkk9Y,9,2,,1,9,2,,11
10654,Dina,1,0,,1,1,0,,1
10655,Slap,0,0,,1,0,0,,0
10656,Kaffetante,39,10,,1,39,10,,49
10657,Kate,57,14,,2,28,7,,71
10658,https://t.co/rSwUfpEuIM,39,10,,1,39,10,,49
10659,ClimateActionNow,52,10,,1,52,10,,62
10660,https://t.co/sWT8vccKjB,52,10,,1,52,10,,62
10661,kolossal,65,13,,1,65,13,,78
10662,https://t.co/rjlAovNdwG,65,13,,1,65,13,,78
10663,travl,1,0,,1,1,0,,1
10664,format,1,0,,1,1,0,,1
10665,Megaklasser,19,9,,1,19,9,,28
10666,læring,25,9,,2,12,4,,34
10667,Underlig,12,3,,1,12,3,,15
10668,ikke-nyhed,12,3,,1,12,3,,15
10669,underlig,46,9,,1,46,9,,55
10670,bevægelighed,46,9,,1,46,9,,55
10671,protektionisme,46,9,,1,46,9,,55
10672,risikoniveau,3,0,,1,3,0,,3
10673,Margrete,45,5,,1,45,5,,50
10674,engagere,50,7,,2,25,4,,57
10675,https://t.co/sg03w40ajn,45,5,,1,45,5,,50
10676,rune,6,2,,1,6,2,,8
10677,kloghed,6,2,,1,6,2,,8
10678,yngel,6,2,,1,6,2,,8
10679,https://t.co/Eqw6jb6pxE,6,2,,1,6,2,,8
10680,fraværende,0,0,,1,0,0,,0
10681,bagside,12,0,,1,12,0,,12
10682,medalje,186,27,,3,62,9,,213
10683,administrativ,12,0,,1,12,0,,12
10684,aldersgrænse,1328,97,,3,443,32,,1425
10685,https://t.co/Rc1a7BfhFA,28,3,,1,28,3,,31
10686,Krause,27,8,,1,27,8,,35
10687,folkestemning,37,1,,1,37,1,,38
10688,pågældende,37,1,,1,37,1,,38
10689,Arbejde,0,0,,1,0,0,,0
10690,"samkørsel""",0,0,,1,0,0,,0
10691,sååå,0,0,,1,0,0,,0
10692,oliepris,17,4,,1,17,4,,21
10693,strøm!#dkpol,17,4,,1,17,4,,21
10694,https://t.co/7W0LRRQ2hs,17,4,,1,17,4,,21
10695,lægeerklæring,124,13,,1,124,13,,137
10696,https://t.co/5cwnzue1L2,124,13,,1,124,13,,137
10697,https://t.co/fhZodsPpzB,1,1,,1,1,1,,2
10698,Toget,1,0,,1,1,0,,1
10699,Langaa,1,0,,1,1,0,,1
10700,kammerat,15,0,,2,8,0,,15
10701,Umbrella-sagen,0,0,,1,0,0,,0
10702,Risiko,0,0,,1,0,0,,0
10703,opdagelse,0,0,,1,0,0,,0
10704,omstrukturering,1,0,,1,1,0,,1
10705,funny,1,0,,1,1,0,,1
10706,Lagermanden,7,3,,1,7,3,,10
10707,kollegerne,7,3,,1,7,3,,10
10708,https://t.co/fOSKEnzYA7,7,3,,1,7,3,,10
10709,Juhuuuu,46,4,,1,46,4,,50
10710,naturgasfyr,46,4,,1,46,4,,50
10711,https://t.co/HZS1eUBQKQ,46,4,,1,46,4,,50
10712,luksusspørgsmål,18,0,,1,18,0,,18
10713,landsplan,0,1,,1,0,1,,1
10714,https://t.co/hpEJErJelk,0,1,,1,0,1,,1
10715,https://t.co/UgyxAxzh8p,66,6,,1,66,6,,72
10716,Skotland,9,3,,1,9,3,,12
10717,Vindstrøm,9,3,,1,9,3,,12
10718,Portlands,9,3,,1,9,3,,12
10719,https://t.co/baZAkIoOyK,9,3,,1,9,3,,12
10720,https://t.co/3lFxy2Swmw,79,15,,1,79,15,,94
10721,IT-produkt,1,0,,1,1,0,,1
10722,https://t.co/WlPvrcvy6D,28,6,,1,28,6,,34
10723,https://t.co/N4r3JrN7nI,420,29,,1,420,29,,449
10724,dokumenterbart,217,16,,1,217,16,,233
10725,https://t.co/Cm5h0ezpN0,217,16,,1,217,16,,233
10726,Højskolesangbogen,62,2,,2,31,1,,64
10727,nationalkonservative,31,1,,1,31,1,,32
10728,https://t.co/njEwIc4d3f,20,6,,1,20,6,,26
10729,ghettoudspil,100,20,,1,100,20,,120
10730,fleres,3,0,,1,3,0,,3
10731,bagkatalog,3,0,,1,3,0,,3
10732,umenneskelig,0,0,,1,0,0,,0
10733,transportudspil,28,6,,1,28,6,,34
10734,udregning,28,6,,1,28,6,,34
10735,cykelforhold,28,6,,1,28,6,,34
10736,delebil,28,6,,1,28,6,,34
10737,https://t.co/XtCIilibu4,28,6,,1,28,6,,34
10738,Psykiatrihospitalet,82,18,,1,82,18,,100
10739,https://t.co/NanNfIPMyW,82,18,,1,82,18,,100
10740,day,2527,818,,1,2527,818,,3345
10741,the,3230,1018,,7,461,145,,4248
10742,continue,2527,818,,1,2527,818,,3345
10743,battle,2527,818,,1,2527,818,,3345
10744,Nærhedsfonden,72,14,,1,72,14,,86
10745,beredskaber,72,14,,1,72,14,,86
10746,https://t.co/MxIE554hAN,72,14,,1,72,14,,86
10747,https://t.co/rFu0nWXoT3,7,1,,1,7,1,,8
10748,finesse,154,9,,1,154,9,,163
10749,https://t.co/F7fsNMGDOH,102,15,,1,102,15,,117
10750,Sårbare,116,20,,1,116,20,,136
10751,forsvarsalliance,153,11,,1,153,11,,164
10752,weareNATO,153,11,,1,153,11,,164
10753,løsgænger,15,1,,1,15,1,,16
10754,andet:-),15,1,,1,15,1,,16
10755,anarkist,15,1,,1,15,1,,16
10756,https://t.co/gfDbDlq1Ce,15,1,,1,15,1,,16
10757,But,21,17,,2,10,8,,38
10758,hell,0,0,,1,0,0,,0
10759,pointeløst,10,3,,1,10,3,,13
10760,pensionsopsparing,10,3,,1,10,3,,13
10761,udebane,10,3,,1,10,3,,13
10762,krigsmetaforen,15,2,,1,15,2,,17
10763,fossile-vækst-økonomi,15,2,,1,15,2,,17
10764,Parallelverden,0,0,,1,0,0,,0
10765,skilt,27,3,,1,27,3,,30
10766,ungdomsorganisation,51,7,,1,51,7,,58
10767,Fencker,51,7,,1,51,7,,58
10768,Vile,51,7,,1,51,7,,58
10769,spids,179,24,,2,90,12,,203
10770,Happy-happy,51,7,,1,51,7,,58
10771,værdiliberalt,51,7,,1,51,7,,58
10772,https://t.co/WuyrGFeo0,51,7,,1,51,7,,58
10773,fremmedkrigere,110,6,,1,110,6,,116
10774,https://t.co/uB32BrIU7i,110,6,,1,110,6,,116
10775,snor,9,1,,1,9,1,,10
10776,SPAR,9,1,,1,9,1,,10
10777,dagligvarebutik,9,1,,1,9,1,,10
10778,Bækmarksbro,9,1,,1,9,1,,10
10779,https://t.co/fO56sQ1l5U,9,1,,1,9,1,,10
10780,indskrænkning,17,2,,1,17,2,,19
10781,Klimalov,20,3,,1,20,3,,23
10782,Biodiversitetslov,22,3,,2,11,2,,25
10783,statsskov,20,3,,1,20,3,,23
10784,https://t.co/ydtK5TfBbQ,20,3,,1,20,3,,23
10785,Anna,109,1,,1,109,1,,110
10786,Libak,109,1,,1,109,1,,110
10787,amerikaner,186,2,,2,93,1,,188
10788,lidelseshistorie,109,1,,1,109,1,,110
10789,mattere,325,58,,2,162,29,,383
10790,nabo,225,10,,4,56,2,,235
10791,Priser,9,3,,1,9,3,,12
10792,belastning,24,5,,2,12,2,,29
10793,skævhed,9,3,,1,9,3,,12
10794,https://t.co/JQGoB7pOV9,9,3,,1,9,3,,12
10795,Uddyb,0,0,,1,0,0,,0
10796,tomt,80,10,,2,40,5,,90
10797,Ups,0,0,,1,0,0,,0
10798,smutte,0,0,,1,0,0,,0
10799,gæld,8,5,,1,8,5,,13
10800,euroobligation,8,5,,1,8,5,,13
10801,http://t.co/Naj2gnzEvN,8,5,,1,8,5,,13
10802,Velfærdssamfundet,2,1,,1,2,1,,3
10803,Mulighederne,8,2,,1,8,2,,10
10804,Tiny,8,2,,1,8,2,,10
10805,Lovgivningen,8,2,,1,8,2,,10
10806,https://t.co/izFFFEmH08,8,2,,1,8,2,,10
10807,fossile-kræft-økonomi,9,2,,1,9,2,,11
10808,oldebarn,9,2,,1,9,2,,11
10809,klima-,9,1,,1,9,1,,10
10810,biodiversitetskrise,9,1,,1,9,1,,10
10811,vertikal,9,1,,1,9,1,,10
10812,https://t.co/hU54dgMakl,9,1,,1,9,1,,10
10813,Rystende,36,0,,1,36,0,,36
10814,kulturtyveri,24,3,,1,24,3,,27
10815,https://t.co/5Pw4cVg2eJ,24,3,,1,24,3,,27
10816,burkaforbuddet,688,14,,1,688,14,,702
10817,Forbuddet,688,14,,1,688,14,,702
10818,halsgreb,688,14,,1,688,14,,702
10819,https://t.co/ggcq7zymZ8,688,14,,1,688,14,,702
10820,https://t.co/IJNfFFzRy1,19,2,,1,19,2,,21
10821,vælgererklæringen,4,2,,1,4,2,,6
10822,Partiet,19,7,,4,5,2,,26
10823,https://t.co/IV3EiLeRT3,9,3,,2,4,2,,12
10824,https://t.co/S32pMxY6D2,4,2,,1,4,2,,6
10825,rav,6,4,,1,6,4,,10
10826,60kr,43,3,,1,43,3,,46
10827,helbred,45,4,,2,22,2,,49
10828,https://t.co/mveU0SwO49,43,3,,1,43,3,,46
10829,minoritetsborgere,0,1,,1,0,1,,1
10830,virkelighedsopfattelse,0,1,,1,0,1,,1
10831,LGBTQ+,0,1,,1,0,1,,1
10832,Bravo,3,1,,1,3,1,,4
10833,Emanuel,3,1,,1,3,1,,4
10834,https://t.co/uHEWmoAm5b,3,1,,1,3,1,,4
10835,ulønnet,0,0,,1,0,0,,0
10836,vækst-økonomien,5,1,,1,5,1,,6
10837,kald,5,1,,1,5,1,,6
10838,kræft-økonomien,5,1,,1,5,1,,6
10839,Schlüter,537,24,,1,537,24,,561
10840,still,537,24,,1,537,24,,561
10841,going,537,24,,1,537,24,,561
10842,strong,573,46,,2,286,23,,619
10843,finanser,537,24,,1,537,24,,561
10844,lune,537,24,,1,537,24,,561
10845,betydningsfuld,1,1,,1,1,1,,2
10846,https://t.co/rmtG6q2kty,1,1,,1,1,1,,2
10847,højrepopulismen,56,4,,1,56,4,,60
10848,https://t.co/Zowz4qckXI,56,4,,1,56,4,,60
10849,naturlov,0,0,,1,0,0,,0
10850,Dong-salget,0,0,,1,0,0,,0
10851,vink,0,0,,1,0,0,,0
10852,vognstang,0,0,,1,0,0,,0
10853,https://t.co/J4sKmhoEYq,0,0,,1,0,0,,0
10854,Nordsø-produktionen,51,10,,1,51,10,,61
10855,oliefest,51,10,,1,51,10,,61
10856,tømmermænd,51,10,,1,51,10,,61
10857,Klokken,51,10,,1,51,10,,61
10858,floor,51,10,,1,51,10,,61
10859,shot,51,10,,1,51,10,,61
10860,quote,0,1,,1,0,1,,1
10861,from,204,89,,4,51,22,,293
10862,this,3,2,,2,2,1,,5
10863,recommend,0,1,,1,0,1,,1
10864,read,0,1,,1,0,1,,1
10865,text,0,1,,1,0,1,,1
10866,bide,0,1,,1,0,1,,1
10867,mertab,27,9,,1,27,9,,36
10868,indlandsis,27,9,,1,27,9,,36
10869,overflade,27,9,,1,27,9,,36
10870,århundredskifte,27,9,,1,27,9,,36
10871,https://t.co/mqnnkQbKdR,27,9,,1,27,9,,36
10872,køkken,16,3,,1,16,3,,19
10873,måltid,16,3,,1,16,3,,19
10874,Veganere,16,3,,1,16,3,,19
10875,Delvise,1,0,,1,1,0,,1
10876,fornemmelse,46,6,,1,46,6,,52
10877,nature,46,6,,1,46,6,,52
10878,back,55,8,,3,18,3,,63
10879,forbundethed,46,6,,1,46,6,,52
10880,pappe,46,6,,1,46,6,,52
10881,virus-udbruddet,46,6,,1,46,6,,52
10882,Meeting,60,26,,2,30,13,,86
10883,with,1348,506,,11,123,46,,1854
10884,https://t.co/3E4CtcE3uL,23,9,,1,23,9,,32
10885,statsmisteren,55,0,,1,55,0,,55
10886,off,3,1,,1,3,1,,4
10887,Komisk,6,0,,1,6,0,,6
10888,ypperst,6,0,,1,6,0,,6
10889,sjette,718,59,,2,359,30,,777
10890,masseuddøen,52,11,,1,52,11,,63
10891,https://t.co/twhFROLYqJ,52,11,,1,52,11,,63
10892,realisme,0,0,,1,0,0,,0
10893,https://t.co/zC8L6tVVQ3,0,0,,1,0,0,,0
10894,Gæt,0,0,,1,0,0,,0
10895,TV-debatten,17,1,,1,17,1,,18
10896,https://t.co/PaDNKFLJnW,17,1,,1,17,1,,18
10897,Instrukskommissionen,10,0,,1,10,0,,10
10898,betragtning,44,7,,1,44,7,,51
10899,vidtgående,44,7,,1,44,7,,51
10900,Københavnererklæring,10,2,,1,10,2,,12
10901,menneskerettighedssystem,10,2,,1,10,2,,12
10902,fremragede,10,2,,1,10,2,,12
10903,https://t.co/Zs1Ni9JWPT,10,2,,1,10,2,,12
10904,Proud,174,60,,2,87,30,,234
10905,getting,66,24,,1,66,24,,90
10906,risk,66,24,,1,66,24,,90
10907,youth,66,24,,1,66,24,,90
10908,jobtraining,66,24,,1,66,24,,90
10909,life,87,41,,2,44,20,,128
10910,skills,66,24,,1,66,24,,90
10911,Jesus,8,0,,1,8,0,,8
10912,check,4,1,,2,2,0,,5
10913,lavindkomstgruppe,1,0,,1,1,0,,1
10914,sodavand,3,0,,1,3,0,,3
10915,juice,3,0,,1,3,0,,3
10916,havredrik,3,0,,1,3,0,,3
10917,skjule,3,0,,1,3,0,,3
10918,sukke,3,0,,1,3,0,,3
10919,kiks,3,0,,1,3,0,,3
10920,ketchup,3,0,,1,3,0,,3
10921,lovning,3,0,,1,3,0,,3
10922,attraktion,71,17,,1,71,17,,88
10923,https://t.co/10QrO5ifhw,71,17,,1,71,17,,88
10924,Arla,10,1,,1,10,1,,11
10925,https://t.co/AxlOCPNT4z,10,1,,1,10,1,,11
10926,CO2-fornuftige,0,0,,1,0,0,,0
10927,Danskere,43,10,,1,43,10,,53
10928,våbenkapløb,43,10,,1,43,10,,53
10929,https://t.co/jEoFUCDuS5,43,10,,1,43,10,,53
10930,minoritetsbørn,4,0,,1,4,0,,4
10931,motiv,1,0,,1,1,0,,1
10932,forfremmelse,8,1,,1,8,1,,9
10933,åndsfætter,8,1,,1,8,1,,9
10934,seehofer,8,1,,1,8,1,,9
10935,https://t.co/zP23Jo5ZTr,8,1,,1,8,1,,9
10936,kulturudspil,13,1,,1,13,1,,14
10937,kulturpolitisk,13,1,,1,13,1,,14
10938,https://t.co/4UcI0Cvwz2,13,1,,1,13,1,,14
10939,Jorden,6,0,,1,6,0,,6
10940,Kunstner,6,0,,1,6,0,,6
10941,Helena,6,0,,1,6,0,,6
10942,Hülsen,6,0,,1,6,0,,6
10943,https://t.co/5U0bH2xSao,6,0,,1,6,0,,6
10944,opstillingsberettiget,17,7,,1,17,7,,24
10945,https://t.co/fvFsonYiKP,33,10,,2,16,5,,43
10946,https://t.co/KNk0EZNMfr,17,7,,1,17,7,,24
10947,interview-offer,23,0,,1,23,0,,23
10948,Frie,15,2,,1,15,2,,17
10949,https://t.co/T7njpYJsh6,15,2,,1,15,2,,17
10950,favorit,2,0,,1,2,0,,2
10951,https://t.co/RqUHLfHYln,2,0,,1,2,0,,2
10952,gennembrud,2,0,,1,2,0,,2
10953,spontan,5,0,,1,5,0,,5
10954,Today,151,46,,2,76,23,,197
10955,President,134,41,,2,67,20,,175
10956,agreed,106,38,,1,106,38,,144
10957,enter,106,38,,1,106,38,,144
10958,partnership,106,38,,1,106,38,,144
10959,kind,106,38,,1,106,38,,144
10960,European,106,38,,1,106,38,,144
10961,foster,106,38,,1,106,38,,144
10962,inclusive,106,38,,1,106,38,,144
10963,growth,148,52,,2,74,26,,200
10964,markets,106,38,,1,106,38,,144
10965,kamdidathold,2,0,,1,2,0,,2
10966,underskrift,12,4,,3,4,1,,16
10967,IranDeal,216,57,,1,216,57,,273
10968,contingent,216,57,,1,216,57,,273
10969,strict,216,57,,1,216,57,,273
10970,compliance,216,57,,1,216,57,,273
10971,Important,216,57,,1,216,57,,273
10972,non-proliferation,216,57,,1,216,57,,273
10973,Will,216,57,,1,216,57,,273
10974,EUCO,216,57,,1,216,57,,273
10975,week,216,57,,1,216,57,,273
10976,Chicago,12,2,,1,12,2,,14
10977,nostalgi,12,2,,1,12,2,,14
10978,højaktuel,12,2,,1,12,2,,14
10979,uger.#dkpol,12,2,,1,12,2,,14
10980,https://t.co/tY46QC0aE2,12,2,,1,12,2,,14
10981,vegetabilsk,14,4,,1,14,4,,18
10982,Demonstrations-,14,4,,1,14,4,,18
10983,quinoa,14,4,,1,14,4,,18
10984,landbrugsstøtteordning,14,4,,1,14,4,,18
10985,CAP,14,4,,1,14,4,,18
10986,https://t.co/QgxwEJiJYQ,14,4,,1,14,4,,18
10987,oprindelig,108,34,,1,108,34,,142
10988,https://t.co/34deFohZaF,108,34,,1,108,34,,142
10989,kompromis,272,23,,1,272,23,,295
10990,Henriksen,5,1,,1,5,1,,6
10991,https://t.co/atWWqXEKet,5,1,,1,5,1,,6
10992,atlet,135,26,,2,68,13,,161
10993,Paralympics,117,19,,1,117,19,,136
10994,AllForRio,174,27,,2,87,14,,201
10995,spilleregel,1,0,,1,1,0,,1
10996,Volsmose,1,0,,1,1,0,,1
10997,neoliberalisme,13,6,,1,13,6,,19
10998,brændsel,9,1,,1,9,1,,10
10999,vedtage,9,1,,1,9,1,,10
11000,https://t.co/LfgrteXDFx,9,1,,1,9,1,,10
11001,https://t.co/x87ARRIXvf,10,4,,1,10,4,,14
11002,demokratiforkæmperne,3,2,,1,3,2,,5
11003,Covid.19,16,1,,1,16,1,,17
11004,Fri,16,1,,1,16,1,,17
11005,Happy,36,22,,1,36,22,,58
11006,welcome,36,22,,1,36,22,,58
11007,prior,36,22,,1,36,22,,58
11008,Malta's,36,22,,1,36,22,,58
11009,Presidency,36,22,,1,36,22,,58
11010,tackle,36,22,,1,36,22,,58
11011,https://t.co/iUvWdJTW7u,36,22,,1,36,22,,58
11012,prideparader,31,6,,1,31,6,,37
11013,pride,31,6,,1,31,6,,37
11014,https://t.co/vXvm4aqRJZ,0,0,,1,0,0,,0
11015,santalekyltur,0,0,,1,0,0,,0
11016,onde,0,0,,1,0,0,,0
11017,samtalekultur,0,0,,1,0,0,,0
11018,Mandag,0,0,,1,0,0,,0
11019,Morgen,0,0,,1,0,0,,0
11020,ugentlig,28,4,,3,9,1,,32
11021,Corona-pressemøder,13,2,,1,13,2,,15
11022,klima-pressemøde,13,2,,1,13,2,,15
11023,klima-krisen,48,5,,3,16,2,,53
11024,aircondition,112,20,,1,112,20,,132
11025,mødelokale,112,20,,1,112,20,,132
11026,https://t.co/Bs8QLX2nfB,112,20,,1,112,20,,132
11027,birthday,42,14,,1,42,14,,56
11028,present,42,14,,1,42,14,,56
11029,borders,42,14,,1,42,14,,56
11030,should,42,14,,1,42,14,,56
11031,big,84,28,,2,42,14,,112
11032,https://t.co/DUxFU7kwJH,42,14,,1,42,14,,56
11033,⁦@SorenPape⁩,23,3,,1,23,3,,26
11034,instrukskommissionens,23,3,,1,23,3,,26
11035,uskyldighedskampagner,23,3,,1,23,3,,26
11036,https://t.co/J2rJ7kKPhf,23,3,,1,23,3,,26
11037,etablissement,31,13,,1,31,13,,44
11038,besættelse,31,13,,1,31,13,,44
11039,https://t.co/O9Qv0ZNX4P,31,13,,1,31,13,,44
11040,oldtid,8,0,,1,8,0,,8
11041,etisk,8,0,,1,8,0,,8
11042,inspirere,8,0,,1,8,0,,8
11043,strande,8,0,,1,8,0,,8
11044,https://t.co/UfKfBhoxMC,8,0,,1,8,0,,8
11045,Sprogskolen,30,8,,1,30,8,,38
11046,Brønderslev,30,8,,1,30,8,,38
11047,Klitgaard,30,8,,1,30,8,,38
11048,Kommunen,30,8,,1,30,8,,38
11049,Ærgerligt,60,9,,1,60,9,,69
11050,politikreds,67,14,,1,67,14,,81
11051,mobil,67,14,,1,67,14,,81
11052,https://t.co/GkRF6xEiZg,67,14,,1,67,14,,81
11053,forlegen,20,0,,1,20,0,,20
11054,Tour-starten,20,0,,1,20,0,,20
11055,George,21,7,,1,21,7,,28
11056,Floyds,21,7,,1,21,7,,28
11057,profilering,21,7,,1,21,7,,28
11058,BlackLivesMatter,21,7,,1,21,7,,28
11059,erhvert,18,0,,1,18,0,,18
11060,konevnetioner,18,0,,1,18,0,,18
11061,https://t.co/mrU26Gixjn,0,0,,1,0,0,,0
11062,Marocco,5,0,,1,5,0,,5
11063,Kasakhstan,5,0,,1,5,0,,5
11064,indre,35,9,,2,18,4,,44
11065,klimatopmødet,5,0,,1,5,0,,5
11066,Nytårsaften,29,6,,1,29,6,,35
11067,raket,29,6,,1,29,6,,35
11068,batteribomber,29,6,,1,29,6,,35
11069,fyrværkeri,29,6,,1,29,6,,35
11070,sprængfarlig,29,6,,1,29,6,,35
11071,antiracisme-dagorden,1,0,,1,1,0,,1
11072,LGBTQ-spørgsmålet,1,0,,1,1,0,,1
11073,Etc.,1,0,,1,1,0,,1
11074,uddybning,29,2,,2,14,1,,31
11075,ovennævnt,14,1,,1,14,1,,15
11076,udenforstående,14,1,,1,14,1,,15
11077,medspiller,14,1,,1,14,1,,15
11078,Pkt,0,0,,1,0,0,,0
11079,slå,0,0,,1,0,0,,0
11080,afskum,1175,81,,1,1175,81,,1256
11081,dehumaniserende,1175,81,,1,1175,81,,1256
11082,kendetegne,1175,81,,1,1175,81,,1256
11083,yderligtgående,1175,81,,1,1175,81,,1256
11084,debatindlæg,46,8,,1,46,8,,54
11085,lig,77,15,,2,38,8,,92
11086,Fagbevægelsens,83,10,,1,83,10,,93
11087,Hovedorganisation,83,10,,1,83,10,,93
11088,heksejagt,124,5,,1,124,5,,129
11089,https://t.co/L8oZfcF6xR,124,5,,1,124,5,,129
11090,birkehæk,17,3,,1,17,3,,20
11091,hæk,17,3,,1,17,3,,20
11092,bærbusk,17,3,,1,17,3,,20
11093,prydbusk,17,3,,1,17,3,,20
11094,frugttræ,17,3,,1,17,3,,20
11095,forvirring,17,3,,1,17,3,,20
11096,utal,17,3,,1,17,3,,20
11097,beskære,17,3,,1,17,3,,20
11098,https://t.co/WjIhjI1YXE,17,3,,1,17,3,,20
11099,Tamilsagen,27,3,,1,27,3,,30
11100,hovmod,27,3,,1,27,3,,30
11101,selvretfærdighedsfølelsen,27,3,,1,27,3,,30
11102,retsfølelse,27,3,,1,27,3,,30
11103,https://t.co/MmJ2AAgxK8,27,3,,1,27,3,,30
11104,minkavlen,18,6,,1,18,6,,24
11105,udløbsdato,18,6,,1,18,6,,24
11106,oliemareridt,18,6,,1,18,6,,24
11107,https://t.co/cdI4flfdG5,18,6,,1,18,6,,24
11108,live-nytårstale,65,12,,1,65,12,,77
11109,profiltekst,1,0,,1,1,0,,1
11110,tagget,0,0,,1,0,0,,0
11111,måske-alvorlig-krise,15,1,,1,15,1,,16
11112,Hallo,650,47,,1,650,47,,697
11113,drengeomskæring,650,47,,1,650,47,,697
11114,nedsmeltning,0,0,,1,0,0,,0
11115,finansverden,0,0,,1,0,0,,0
11116,Naturen,9,2,,1,9,2,,11
11117,Kjartan,18,4,,2,9,2,,22
11118,Arngrim,9,2,,1,9,2,,11
11119,Bob,9,2,,1,9,2,,11
11120,Dylan,9,2,,1,9,2,,11
11121,Beatles,9,2,,1,9,2,,11
11122,høstblomst,9,2,,1,9,2,,11
11123,Pow,9,2,,1,9,2,,11
11124,wow,43,12,,2,22,6,,55
11125,udgangsreplik,9,2,,1,9,2,,11
11126,https://t.co/a4Icqppx4c,9,2,,1,9,2,,11
11127,kontakthjælp,7,1,,1,7,1,,8
11128,opleve,7,1,,1,7,1,,8
11129,landing,2,0,,1,2,0,,2
11130,Argumentet,20,2,,1,20,2,,22
11131,Corona-krise,20,2,,1,20,2,,22
11132,klimaområde,20,2,,1,20,2,,22
11133,hasteforespørgsler,0,0,,1,0,0,,0
11134,BLM,1,1,,1,1,1,,2
11135,Antifa,1,1,,1,1,1,,2
11136,Hiv,1,1,,1,1,1,,2
11137,højreradikal,11,6,,2,6,3,,17
11138,konspirationsteorier,1,1,,1,1,1,,2
11139,tandlæge,2,0,,1,2,0,,2
11140,Skift,2,0,,1,2,0,,2
11141,Gabriel,8,1,,1,8,1,,9
11142,Schulz,8,1,,1,8,1,,9
11143,gætte,8,1,,2,4,0,,9
11144,naturmål,0,0,,1,0,0,,0
11145,ligeud,47,4,,1,47,4,,51
11146,hær,47,4,,1,47,4,,51
11147,https://t.co/sqtzjx7rP6,47,4,,1,47,4,,51
11148,smittespredning,17,7,,1,17,7,,24
11149,udsmidning,17,7,,1,17,7,,24
11150,spildevand,17,7,,1,17,7,,24
11151,https://t.co/j8c4G2EZHU,17,7,,1,17,7,,24
11152,børnehjem,50,4,,1,50,4,,54
11153,erstatning,50,4,,1,50,4,,54
11154,godhavnsdrengene,50,4,,1,50,4,,54
11155,privilege,284,33,,2,142,16,,317
11156,open,37,13,,1,37,13,,50
11157,against,85,33,,2,42,16,,118
11158,cancer,37,13,,1,37,13,,50
11159,genbrugsvenligt,0,0,,1,0,0,,0
11160,V-medlem,10,2,,1,10,2,,12
11161,stifte,10,2,,1,10,2,,12
11162,Formanden,10,2,,1,10,2,,12
11163,raketvidenskab,5,1,,1,5,1,,6
11164,honningbi,5,1,,1,5,1,,6
11165,honningbi-bistader,5,1,,1,5,1,,6
11166,https://t.co/zXM1rviHJg,5,1,,1,5,1,,6
11167,indføre,8,0,,1,8,0,,8
11168,personalepolitik,0,0,,1,0,0,,0
11169,bevidst,297,17,,3,99,6,,314
11170,organisationskultur,0,0,,1,0,0,,0
11171,ongoing,0,0,,1,0,0,,0
11172,Good,540,136,,7,77,19,,676
11173,meeting,231,72,,3,77,24,,303
11174,proud,46,16,,1,46,16,,62
11175,contribute,46,16,,1,46,16,,62
11176,ensuring,46,16,,1,46,16,,62
11177,Estonia,46,16,,1,46,16,,62
11178,https://t.co/eDnBZ36w16,46,16,,1,46,16,,62
11179,fejl-formulering,0,0,,1,0,0,,0
11180,SDG,136,48,,2,68,24,,184
11181,discuss,111,33,,1,111,33,,144
11182,how,111,33,,1,111,33,,144
11183,partnerships,111,33,,1,111,33,,144
11184,help,111,33,,1,111,33,,144
11185,https://t.co/acVCgqVkL8,111,33,,1,111,33,,144
11186,bragesnak,6,1,,1,6,1,,7
11187,Taberne,6,1,,1,6,1,,7
11188,LGBTdk,25,6,,1,25,6,,31
11189,https://t.co/9697K9GgqA,25,6,,1,25,6,,31
11190,skybrud,2,1,,1,2,1,,3
11191,Danmarkde,2,1,,1,2,1,,3
11192,californisk,2,1,,1,2,1,,3
11193,skovbrand,2,1,,1,2,1,,3
11194,Californien,2,1,,1,2,1,,3
11195,https://t.co/6aPgvmMtML,2,1,,1,2,1,,3
11196,spansk,13,7,,1,13,7,,20
11197,oppositions-politikere,13,7,,1,13,7,,20
11198,Katalonien,13,7,,1,13,7,,20
11199,EU-land.https://t.co/CKiZktsYpJ,13,7,,1,13,7,,20
11200,formulering,16,1,,2,8,0,,17
11201,fråde,15,1,,1,15,1,,16
11202,Ældrebyrde,2,1,,1,2,1,,3
11203,https://t.co/W9jWm6NTEs,2,1,,1,2,1,,3
11204,detnæstedanmark,2,1,,1,2,1,,3
11205,frustrere,2,0,,1,2,0,,2
11206,ambitionsniveau,2,0,,1,2,0,,2
11207,klima-venner,2,0,,1,2,0,,2
11208,ekstraordinær,21,1,,1,21,1,,22
11209,coronamagt,21,1,,1,21,1,,22
11210,https://t.co/8ci6bqMXMF,10,3,,1,10,3,,13
11211,fordærdeligt,1,0,,1,1,0,,1
11212,stemmeseddel,19,4,,2,10,2,,23
11213,https://t.co/ZkvBuNy8Tw,3,1,,1,3,1,,4
11214,https://t.co/w8BW7dBa1,3,1,,1,3,1,,4
11215,Efterlønnen,11,0,,1,11,0,,11
11216,1970’erne,11,0,,1,11,0,,11
11217,https://t.co/Hj32Lthf0e,1,0,,1,1,0,,1
11218,fremadrettet,1,0,,1,1,0,,1
11219,dansk-indisk,1,0,,1,1,0,,1
11220,"mv.,men",1,0,,1,1,0,,1
11221,menneskerettighedsfortaler,1,0,,1,1,0,,1
11222,Kashmir,9,2,,2,4,1,,11
11223,velfungerende,142,8,,1,142,8,,150
11224,misforståelse,163,11,,2,82,6,,174
11225,medisterpølse,553,23,,1,553,23,,576
11226,Aldi,553,23,,1,553,23,,576
11227,BørnErBørn,553,23,,1,553,23,,576
11228,Merci,24,0,,1,24,0,,24
11229,Stemningsbilleder,24,0,,1,24,0,,24
11230,Største,84,23,,2,42,12,,107
11231,valgsejr,38,8,,2,19,4,,46
11232,socialliberal,24,0,,1,24,0,,24
11233,Presidentielles2017,24,0,,1,24,0,,24
11234,EnMarche,24,0,,1,24,0,,24
11235,https://t.co/P9qtilpj7W,24,0,,1,24,0,,24
11236,Præcist,19,0,,1,19,0,,19
11237,terroristisk,10,2,,1,10,2,,12
11238,Wien,10,2,,1,10,2,,12
11239,overherredømme-militser,10,2,,1,10,2,,12
11240,Grise,40,7,,1,40,7,,47
11241,hedebølge,40,7,,1,40,7,,47
11242,gris,40,7,,1,40,7,,47
11243,Varmepumper,1,0,,1,1,0,,1
11244,energirenoveringe,1,0,,1,1,0,,1
11245,fjernvarmeområderne,1,0,,1,1,0,,1
11246,https://t.co/5TJCLpTC3L,1,0,,1,1,0,,1
11247,provokere,17,1,,1,17,1,,18
11248,kristne,17,1,,1,17,1,,18
11249,ambassadør,27,4,,1,27,4,,31
11250,Ambassadør,27,4,,1,27,4,,31
11251,Vibeke,27,4,,1,27,4,,31
11252,gæstfrihed,27,4,,1,27,4,,31
11253,lærerig,27,4,,1,27,4,,31
11254,Stockholm,27,4,,1,27,4,,31
11255,landskab,42,14,,1,42,14,,56
11256,Emma,42,14,,1,42,14,,56
11257,Goldman,42,14,,1,42,14,,56
11258,åndelig,42,14,,1,42,14,,56
11259,oldemor,42,14,,1,42,14,,56
11260,hetze,0,0,,1,0,0,,0
11261,indormation,33,2,,1,33,2,,35
11262,såbare,33,2,,1,33,2,,35
11263,Selvforsørgende,1,0,,1,1,0,,1
11264,Jokeren,30,9,,1,30,9,,39
11265,fælde,30,9,,1,30,9,,39
11266,snue,30,9,,1,30,9,,39
11267,miljøfilter,30,9,,1,30,9,,39
11268,kassebåndet,30,9,,1,30,9,,39
11269,plastikpose,30,9,,1,30,9,,39
11270,frede,17,1,,1,17,1,,18
11271,Havbunden,17,1,,1,17,1,,18
11272,landnatur,17,1,,1,17,1,,18
11273,rive,17,1,,1,17,1,,18
11274,økosystem,17,1,,1,17,1,,18
11275,https://t.co/pLRZj2fCES,17,1,,1,17,1,,18
11276,between,123,28,,2,62,14,,151
11277,boy,8,0,,1,8,0,,8
11278,brok,12,1,,1,12,1,,13
11279,cykelrytter,12,1,,1,12,1,,13
11280,udbrud,12,1,,1,12,1,,13
11281,High,12,1,,1,12,1,,13
11282,five,12,1,,1,12,1,,13
11283,fremmedhad,13,1,,1,13,1,,14
11284,https://t.co/O1tKhOFENS,13,1,,1,13,1,,14
11285,https://t.co/1MmbFCqg6e,0,0,,1,0,0,,0
11286,magtfuldkommen,3,0,,2,2,0,,3
11287,Also,28,3,,1,28,3,,31
11288,imagine,28,3,,1,28,3,,31
11289,choice,28,3,,1,28,3,,31
11290,Election2020,28,3,,1,28,3,,31
11291,ElectionDay,28,3,,1,28,3,,31
11292,festdag,435,28,,1,435,28,,463
11293,https://t.co/LUprBFbX0L,435,28,,1,435,28,,463
11294,Hader,4,0,,1,4,0,,4
11295,forfatterskab,4,0,,1,4,0,,4
11296,store-små-glæder,11,2,,1,11,2,,13
11297,juledag,11,2,,1,11,2,,13
11298,Torben,11,2,,1,11,2,,13
11299,https://t.co/YBqJKExeCd,11,2,,1,11,2,,13
11300,way,70,19,,1,70,19,,89
11301,reacting,70,19,,1,70,19,,89
11302,communicating,70,19,,1,70,19,,89
11303,something,70,19,,1,70,19,,89
11304,normally,70,19,,1,70,19,,89
11305,societies,70,19,,1,70,19,,89
11306,tipping,70,19,,1,70,19,,89
11307,followers,70,19,,1,70,19,,89
11308,reading,70,19,,1,70,19,,89
11309,VoteBidenHarrisToSaveAmerica,70,19,,1,70,19,,89
11310,glashus,96,11,,2,48,6,,107
11311,metoo,78,9,,1,78,9,,87
11312,https://t.co/39D1MmBwoE,78,9,,1,78,9,,87
11313,Agree,20,9,,1,20,9,,29
11314,treaty,20,9,,1,20,9,,29
11315,changes,20,9,,1,20,9,,29
11316,Must,20,9,,1,20,9,,29
11317,essentials,20,9,,1,20,9,,29
11318,grand,20,9,,1,20,9,,29
11319,projects,20,9,,1,20,9,,29
11320,institutional,20,9,,1,20,9,,29
11321,discussions,20,9,,1,20,9,,29
11322,SOTEU,20,9,,1,20,9,,29
11323,Dennis,5,1,,1,5,1,,6
11324,Nørmark,5,1,,1,5,1,,6
11325,bestseller,5,1,,1,5,1,,6
11326,Pseudoarbejde,5,1,,1,5,1,,6
11327,https://t.co/yBpGOAU2x1,5,1,,1,5,1,,6
11328,luftudspil,3,0,,1,3,0,,3
11329,Dyrene,4,1,,1,4,1,,5
11330,bur,4,1,,1,4,1,,5
11331,fuldtidsliv,4,1,,1,4,1,,5
11332,stald,4,1,,1,4,1,,5
11333,frisind,20,1,,1,20,1,,21
11334,https://t.co/67zHySjSuu,2,1,,1,2,1,,3
11335,cykelfradrag,2,1,,1,2,1,,3
11336,kørselsfradrag,2,1,,1,2,1,,3
11337,Cykelfradraget,2,1,,1,2,1,,3
11338,arbejdssted,2,1,,1,2,1,,3
11339,bilkørselsfradrag,2,1,,1,2,1,,3
11340,Hven,9,1,,1,9,1,,10
11341,ejendom,9,1,,1,9,1,,10
11342,ABBA,13,4,,1,13,4,,17
11343,børnedag,13,4,,1,13,4,,17
11344,https://t.co/LhKskWEaVQ,13,4,,1,13,4,,17
11345,værdifuld,32,10,,1,32,10,,42
11346,nøgleord,32,10,,1,32,10,,42
11347,https://t.co/lcLu6ErJTG,32,10,,1,32,10,,42
11348,Great,179,55,,2,90,28,,234
11349,Germany,119,28,,1,119,28,,147
11350,league,119,28,,1,119,28,,147
11351,possible,119,28,,1,119,28,,147
11352,cooperation,283,96,,3,94,32,,379
11353,https://t.co/iUJtbKf9F1,119,28,,1,119,28,,147
11354,Kristoffer,101,0,,1,101,0,,101
11355,Eriksen,101,0,,1,101,0,,101
11356,chefredaktør,105,0,,2,52,0,,105
11357,Ekstrabladet,101,0,,1,101,0,,101
11358,buks,101,0,,1,101,0,,101
11359,Avs,101,0,,1,101,0,,101
11360,https://t.co/SC3KCWnPzJ,34,14,,1,34,14,,48
11361,Midlertidighed,13,3,,1,13,3,,16
11362,grænsehandel,5,2,,1,5,2,,7
11363,https://t.co/3zeoKmMDQ6,22,4,,1,22,4,,26
11364,fredagsbøn,3,0,,1,3,0,,3
11365,Mosker,3,0,,1,3,0,,3
11366,Christchurch,3,0,,1,3,0,,3
11367,Zealand,3,0,,1,3,0,,3
11368,Ekstremisme,3,0,,1,3,0,,3
11369,fordømmelse,3,0,,1,3,0,,3
11370,ChristChurch,3,0,,1,3,0,,3
11371,Nope,1,0,,1,1,0,,1
11372,Anonym,8,0,,1,8,0,,8
11373,thiesen,3,0,,1,3,0,,3
11374,Dum,3,0,,1,3,0,,3
11375,perker,3,0,,1,3,0,,3
11376,terroristsympatisør,3,0,,1,3,0,,3
11377,samfundstaber,3,0,,1,3,0,,3
11378,NSA,123,24,,3,41,8,,147
11379,to-tre,1,0,,1,1,0,,1
11380,https://t.co/xoPTElywGV,16,1,,1,16,1,,17
11381,sætning,235,5,,2,118,2,,240
11382,citere,67,2,,1,67,2,,69
11383,https://t.co/u5wJEefP7Q,67,2,,1,67,2,,69
11384,https://t.co/uLnRdWwrZG,29,13,,1,29,13,,42
11385,allerbedste,1,0,,1,1,0,,1
11386,engangsplast,1,0,,1,1,0,,1
11387,glasbeholdere,1,0,,1,1,0,,1
11388,keramik,1,0,,1,1,0,,1
11389,Here,1,0,,1,1,0,,1
11390,again,1,0,,1,1,0,,1
11391,Farberger,34,10,,1,34,10,,44
11392,https://t.co/EBgfowlntC,34,10,,1,34,10,,44
11393,fiskenet,15,2,,1,15,2,,17
11394,attraktiv,15,2,,1,15,2,,17
11395,farvand,15,2,,1,15,2,,17
11396,fisk,17,3,,2,8,2,,20
11397,genanvendelse,15,2,,1,15,2,,17
11398,https://t.co/Gjhaa0euch,15,2,,1,15,2,,17
11399,Marlon,4,1,,1,4,1,,5
11400,Brando,4,1,,1,4,1,,5
11401,Johnny,4,1,,1,4,1,,5
11402,Carson,4,1,,1,4,1,,5
11403,Talkshow,4,1,,1,4,1,,5
11404,Jr.,4,1,,1,4,1,,5
11405,Arnoldi,4,1,,1,4,1,,5
11406,https://t.co/Io7aEh4vov,4,1,,1,4,1,,5
11407,Yesterday,3,1,,1,3,1,,4
11408,Danish,96,29,,3,32,10,,125
11409,premier,3,1,,1,3,1,,4
11410,outstanding,3,1,,1,3,1,,4
11411,blowing,3,1,,1,3,1,,4
11412,documentary,3,1,,1,3,1,,4
11413,Please,3,1,,1,3,1,,4
11414,trailer,3,1,,1,3,1,,4
11415,Then,3,1,,1,3,1,,4
11416,understand,3,1,,1,3,1,,4
11417,why,3,1,,1,3,1,,4
11418,inspired,3,1,,1,3,1,,4
11419,https://t.co/RIwOyVFhgR,3,1,,1,3,1,,4
11420,forbrugs-strategien,5,1,,1,5,1,,6
11421,vækst-økonomiske-tænkning,5,1,,1,5,1,,6
11422,https://t.co/jrhciYeLwD,89,9,,1,89,9,,98
11423,Impressed,119,55,,1,119,55,,174
11424,taking,119,55,,1,119,55,,174
11425,responsibilty,119,55,,1,119,55,,174
11426,kid,238,110,,2,119,55,,348
11427,benefit,119,55,,1,119,55,,174
11428,Lego,119,55,,1,119,55,,174
11429,education,119,55,,1,119,55,,174
11430,programme,119,55,,1,119,55,,174
11431,https://t.co/Z1vJvxM0gL,119,55,,1,119,55,,174
11432,nystarte,10,0,,1,10,0,,10
11433,småbønder,10,0,,1,10,0,,10
11434,indførelse,3,1,,1,3,1,,4
11435,seksualundervisning,3,1,,1,3,1,,4
11436,https://t.co/8chjVVsR1s,3,1,,1,3,1,,4
11437,opholdstilladelse,2,0,,1,2,0,,2
11438,unstable,104,32,,1,104,32,,136
11439,Nordic,208,64,,2,104,32,,272
11440,more,113,32,,2,56,16,,145
11441,important,104,32,,1,104,32,,136
11442,than,104,32,,1,104,32,,136
11443,Our,104,32,,1,104,32,,136
11444,frontrunners,104,32,,1,104,32,,136
11445,NordicCouncil,104,32,,1,104,32,,136
11446,https://t.co/LrwY7hNOPP,79,2,,1,79,2,,81
11447,nulstilling,7,1,,1,7,1,,8
11448,infrastruktur-prioriteringer,7,1,,1,7,1,,8
11449,forurening,42,5,,1,42,5,,47
11450,embedsmandsniveau,42,5,,1,42,5,,47
11451,kommuneniveau,98,14,,2,49,7,,112
11452,https://t.co/4h3Ixy8cZA,42,5,,1,42,5,,47
11453,lyveprinsessen,192,13,,1,192,13,,205
11454,Glimrende,29,0,,1,29,0,,29
11455,rødbedefarvet,18,2,,1,18,2,,20
11456,Statsborgerskabet,18,2,,1,18,2,,20
11457,tillidserklæring,18,2,,1,18,2,,20
11458,retsstat!?#dkpol,9,2,,1,9,2,,11
11459,https://t.co/1o4jLaQOjR,9,2,,1,9,2,,11
11460,milliardbeløb,29,2,,1,29,2,,31
11461,Landbrugpakken,58,7,,1,58,7,,65
11462,basis,58,7,,1,58,7,,65
11463,moderniseringsstyrelsen,44,17,,1,44,17,,61
11464,https://t.co/TgGZAieWbV,44,17,,1,44,17,,61
11465,proportional,0,0,,1,0,0,,0
11466,klimabelastningen,0,0,,1,0,0,,0
11467,verdenskrig,6,0,,1,6,0,,6
11468,faglitteratur,6,0,,1,6,0,,6
11469,Hmmm,0,0,,1,0,0,,0
11470,https://t.co/ZkhxSuaRCP,0,0,,1,0,0,,0
11471,integrationsydelsen,49,8,,3,16,3,,57
11472,Safe,391,215,,1,391,215,,606
11473,inauguration,391,215,,1,391,215,,606
11474,Lázaro,391,215,,1,391,215,,606
11475,Cárdenas,391,215,,1,391,215,,606
11476,https://t.co/0HMOJzuSci,391,215,,1,391,215,,606
11477,Frisind,85,15,,1,85,15,,100
11478,Fællesskab,85,15,,1,85,15,,100
11479,værne,287,43,,2,144,22,,330
11480,menneskesmugler,85,15,,1,85,15,,100
11481,dørstopper,3,0,,1,3,0,,3
11482,Læring,3,0,,1,3,0,,3
11483,https://t.co/xz5vN1h5pA,3,0,,1,3,0,,3
11484,melodi,104,5,,1,104,5,,109
11485,was,33,0,,1,33,0,,33
11486,Forholdene,62,10,,1,62,10,,72
11487,Ellebæk,62,10,,1,62,10,,72
11488,inhuman,62,10,,1,62,10,,72
11489,Europa.lige,62,10,,1,62,10,,72
11490,https://t.co/gYUEHB93Ih,62,10,,1,62,10,,72
11491,https://t.co/mVMHuYWROP,62,10,,1,62,10,,72
11492,Forrige,10,5,,1,10,5,,15
11493,dybde,10,5,,1,10,5,,15
11494,Folketingsåret,13,1,,1,13,1,,14
11495,ukonkret,13,1,,1,13,1,,14
11496,livsvigtig,13,1,,1,13,1,,14
11497,https://t.co/oR3rAw59FS,13,1,,1,13,1,,14
11498,efterfølgelse,345,40,,1,345,40,,385
11499,Skræmmende,0,0,,1,0,0,,0
11500,https://t.co/HGxGRgTagN,0,0,,1,0,0,,0
11501,EU-ratifikation,6,4,,1,6,4,,10
11502,udvinding,0,0,,1,0,0,,0
11503,indenrigsflyvning,0,0,,1,0,0,,0
11504,racial,666,48,,1,666,48,,714
11505,profiling,666,48,,1,666,48,,714
11506,skaldethed,666,48,,1,666,48,,714
11507,gov,48,20,,1,48,20,,68
11508,intends,48,20,,1,48,20,,68
11509,soldiers,48,20,,1,48,20,,68
11510,Afghanistan,48,20,,1,48,20,,68
11511,oplag,7,0,,1,7,0,,7
11512,tryk,7,0,,1,7,0,,7
11513,Hon,1,0,,1,1,0,,1
11514,kulturinstitut,138,22,,1,138,22,,160
11515,Delhi,138,22,,1,138,22,,160
11516,indisk,138,22,,1,138,22,,160
11517,udfolde,138,22,,1,138,22,,160
11518,https://t.co/DS41yvEKC4,138,22,,1,138,22,,160
11519,Principper,5,1,,1,5,1,,6
11520,holdbar,5,1,,1,5,1,,6
11521,højreekstremisme,43,9,,1,43,9,,52
11522,nazi-kriseberedskab,43,9,,1,43,9,,52
11523,https://t.co/zgTJZlN57V,43,9,,1,43,9,,52
11524,mangfoldig,0,1,,1,0,1,,1
11525,Værdikrigere,0,1,,1,0,1,,1
11526,smådesperat,0,1,,1,0,1,,1
11527,https://t.co/cmXUOPdBDP,0,1,,1,0,1,,1
11528,GreenNewDeal,14,4,,1,14,4,,18
11529,https://t.co/sFrZlHtYVp,14,4,,1,14,4,,18
11530,Finansiel,241,19,,1,241,19,,260
11531,Stabilitet,241,19,,1,241,19,,260
11532,milliardstor,241,19,,1,241,19,,260
11533,https://t.co/koiSfTVt1u,13,1,,1,13,1,,14
11534,gengivelse,162,10,,1,162,10,,172
11535,FB-kronik,162,10,,1,162,10,,172
11536,erhvervsvilkår,30,10,,1,30,10,,40
11537,Bang,30,10,,1,30,10,,40
11538,Olufsen,30,10,,1,30,10,,40
11539,Jakobsen,30,10,,1,30,10,,40
11540,https://t.co/wHEIvv9h2J,30,10,,1,30,10,,40
11541,Frifundet,335,24,,1,335,24,,359
11542,injuriere,335,24,,1,335,24,,359
11543,immunitet,335,24,,1,335,24,,359
11544,Udvalget,335,24,,1,335,24,,359
11545,Forretningsorden,335,24,,1,335,24,,359
11546,https://t.co/ju2CS6a5g6,335,24,,1,335,24,,359
11547,Kælderen,1,0,,1,1,0,,1
11548,etage,1,0,,1,1,0,,1
11549,protreptiske,1,0,,1,1,0,,1
11550,coaching,1,0,,1,1,0,,1
11551,Reglone,3,1,,1,3,1,,4
11552,Erhvervet,3,1,,1,3,1,,4
11553,frist,3,1,,1,3,1,,4
11554,.@pomaEB,15,3,,1,15,3,,18
11555,Speak,15,3,,1,15,3,,18
11556,friend,15,3,,1,15,3,,18
11557,pejlemærke,15,3,,1,15,3,,18
11558,styrt,710,16,,1,710,16,,726
11559,nyde,710,16,,1,710,16,,726
11560,avancement,710,16,,1,710,16,,726
11561,Alperne,710,16,,1,710,16,,726
11562,sti,64,4,,1,64,4,,68
11563,udlænge,1,0,,1,1,0,,1
11564,autonomi,8,2,,1,8,2,,10
11565,kashmir,8,2,,1,8,2,,10
11566,many,268,37,,2,134,18,,305
11567,hongkongers,21,17,,1,21,17,,38
11568,leave,21,17,,1,21,17,,38
11569,city,21,17,,1,21,17,,38
11570,grew,21,17,,1,21,17,,38
11571,now,21,17,,1,21,17,,38
11572,some,21,17,,1,21,17,,38
11573,their,21,17,,1,21,17,,38
11574,political,21,17,,1,21,17,,38
11575,refugees.#12HKyouths,21,17,,1,21,17,,38
11576,IPAC,27,18,,2,14,9,,45
11577,.@DanJoergensen,45,10,,1,45,10,,55
11578,kompas,45,10,,1,45,10,,55
11579,affalds-sagen,45,10,,1,45,10,,55
11580,affaldssystem,45,10,,1,45,10,,55
11581,DONG-sagen,45,10,,1,45,10,,55
11582,https://t.co/c5JucdBCu9,45,10,,1,45,10,,55
11583,MEPere,136,22,,1,136,22,,158
11584,https://t.co/YdqLdQky78,136,22,,1,136,22,,158
11585,https://t.co/9P3KIz7Hkk,19,2,,1,19,2,,21
11586,tyrkisk,40,1,,1,40,1,,41
11587,nationalekonservstive,11,2,,1,11,2,,13
11588,teenagerfamilier,0,0,,1,0,0,,0
11589,Trænger,0,0,,1,0,0,,0
11590,Teenagertiden,0,0,,1,0,0,,0
11591,fossilfri,13,2,,1,13,2,,15
11592,logistik,13,2,,1,13,2,,15
11593,partikeludledning,13,2,,1,13,2,,15
11594,https://t.co/svKxkXxZl4,13,2,,1,13,2,,15
11595,fordømme,74,15,,1,74,15,,89
11596,fredelig,74,15,,1,74,15,,89
11597,blacklivesmatter,74,15,,1,74,15,,89
11598,nedbryde,18,4,,1,18,4,,22
11599,Morgendagens,18,4,,1,18,4,,22
11600,Raworth,18,4,,1,18,4,,22
11601,Afkald,1,0,,1,1,0,,1
11602,frihedsbegreber,1,0,,1,1,0,,1
11603,canadisk,3,1,,1,3,1,,4
11604,8.udbudrunde,20,4,,1,20,4,,24
11605,https://t.co/KznCfU7YJW,20,4,,1,20,4,,24
11606,goys,93,3,,1,93,3,,96
11607,https://t.co/2j8YVd6Ipq,1,0,,1,1,0,,1
11608,PLUS,1,0,,1,1,0,,1
11609,civilisationssammenbrud,1,0,,1,1,0,,1
11610,SAMME,1,0,,1,1,0,,1
11611,olieindustri,0,0,,1,0,0,,0
11612,valgresultat,186,19,,1,186,19,,205
11613,Løkkegaard,186,19,,1,186,19,,205
11614,Kanon,186,19,,1,186,19,,205
11615,optælling,186,19,,1,186,19,,205
11616,https://t.co/53Wi1Yah47,186,19,,1,186,19,,205
11617,Kulturhomogenitet,37,2,,1,37,2,,39
11618,sande,3,0,,1,3,0,,3
11619,true,250,20,,2,125,10,,270
11620,cost,3,0,,1,3,0,,3
11621,pesticideforbrug,21,2,,1,21,2,,23
11622,bomuldsdyrkning,21,2,,1,21,2,,23
11623,Madhuriama,21,2,,1,21,2,,23
11624,https://t.co/9DVFlbpg1A,21,2,,1,21,2,,23
11625,Eksamen,8,0,,1,8,0,,8
11626,Arh,2,0,,1,2,0,,2
11627,grønen,2,0,,1,2,0,,2
11628,TalOp,2,0,,1,2,0,,2
11629,tæthed,0,0,,1,0,0,,0
11630,gangruter,0,0,,1,0,0,,0
11631,pjatte,92,1,,1,92,1,,93
11632,pjank,92,1,,1,92,1,,93
11633,dyd,2,0,,1,2,0,,2
11634,opportun,2,0,,1,2,0,,2
11635,ikke-reaktion,5,2,,1,5,2,,7
11636,Boel,5,2,,1,5,2,,7
11637,https://t.co/AxzCdpLjYM,147,19,,1,147,19,,166
11638,fritime,0,0,,1,0,0,,0
11639,lokalmiljø,0,0,,1,0,0,,0
11640,produktionsforhold,2,0,,1,2,0,,2
11641,fritgående,2,0,,1,2,0,,2
11642,mark,2,0,,1,2,0,,2
11643,Klogt,2599,52,,1,2599,52,,2651
11644,rebuilding,108,36,,1,108,36,,144
11645,following,108,36,,1,108,36,,144
11646,terrible,108,36,,1,108,36,,144
11647,hurricanes,108,36,,1,108,36,,144
11648,https://t.co/UYcgQohYcn,0,0,,1,0,0,,0
11649,retninglinjer,403,10,,1,403,10,,413
11650,tilbagevenden,403,10,,1,403,10,,413
11651,børnevenlig,403,10,,1,403,10,,413
11652,Rigshospitalet,11,3,,1,11,3,,14
11653,Rygtet,11,3,,1,11,3,,14
11654,nabo-stuen,11,3,,1,11,3,,14
11655,prins,11,3,,1,11,3,,14
11656,Vincent,11,3,,1,11,3,,14
11657,prinsesse,11,3,,1,11,3,,14
11658,https://t.co/i46YwAt6iR,11,3,,1,11,3,,14
11659,https://t.co/yLKCO86iPI,32,16,,1,32,16,,48
11660,Gider,44,1,,1,44,1,,45
11661,hoppe,44,1,,1,44,1,,45
11662,Madsens,44,1,,1,44,1,,45
11663,firedages,297,12,,1,297,12,,309
11664,valgprogram,297,12,,1,297,12,,309
11665,mæthedspunktet,4,3,,1,4,3,,7
11666,overskride,4,3,,1,4,3,,7
11667,klima-man,4,3,,1,4,3,,7
11668,must,90,47,,3,30,16,,137
11669,kv09,5,1,,1,5,1,,6
11670,Leif,5,1,,1,5,1,,6
11671,pollleder,5,1,,1,5,1,,6
11672,Kongen,0,0,,1,0,0,,0
11673,Thyregod,0,0,,1,0,0,,0
11674,fortjene,0,0,,1,0,0,,0
11675,YES,42,3,,3,14,1,,45
11676,https://t.co/0sqoaDXTy7,14,1,,1,14,1,,15
11677,https://t.co/KGr5me1OKj,121,14,,1,121,14,,135
11678,diskriminere,101,4,,1,101,4,,105
11679,heldig,20,0,,2,10,0,,20
11680,fluffy,0,2,,1,0,2,,2
11681,silotænkning,16,7,,1,16,7,,23
11682,https://t.co/vObICeWu0F,16,7,,1,16,7,,23
11683,https://t.co/tCVZezdpsp,145,21,,1,145,21,,166
11684,pensionistparti,0,0,,1,0,0,,0
11685,går:-,0,0,,1,0,0,,0
11686,cykelsnak,34,1,,1,34,1,,35
11687,partilinien,2,0,,1,2,0,,2
11688,tog-nyhed,30,8,,1,30,8,,38
11689,Sovevognen,30,8,,1,30,8,,38
11690,https://t.co/0Y4JzUvjbU,30,8,,1,30,8,,38
11691,vælgererklæring,7,3,,1,7,3,,10
11692,https://t.co/86BB8ZJ96i,7,3,,1,7,3,,10
11693,https://t.co/twjO6doWYp,22,7,,1,22,7,,29
11694,granskning,4,1,,1,4,1,,5
11695,mink-beslutningsprocessen,4,1,,1,4,1,,5
11696,Bronce,57,8,,1,57,8,,65
11697,49erFX-sejlerne,57,8,,1,57,8,,65
11698,Jena,57,8,,1,57,8,,65
11699,Salskov-Iversen,57,8,,1,57,8,,65
11700,gøgler,14,1,,1,14,1,,15
11701,gran,14,1,,1,14,1,,15
11702,Annika,14,1,,1,14,1,,15
11703,Aakjær,14,1,,1,14,1,,15
11704,https://t.co/OsUMymx29U,14,1,,1,14,1,,15
11705,søvn,2,0,,1,2,0,,2
11706,cphpride,42,4,,1,42,4,,46
11707,u-landsstøtte,4,1,,1,4,1,,5
11708,U-landene,4,1,,1,4,1,,5
11709,https://t.co/lb5b5mj1AL,4,1,,1,4,1,,5
11710,menneskesyn,4,2,,2,2,1,,6
11711,Tilsvarende,1,0,,1,1,0,,1
11712,afstandtagen,1,0,,1,1,0,,1
11713,FE-skandalen,61,12,,1,61,12,,73
11714,forpligtige,61,12,,1,61,12,,73
11715,suppe,4,1,,1,4,1,,5
11716,debatstil,4,1,,1,4,1,,5
11717,kendemærke,4,1,,1,4,1,,5
11718,sikken,4,1,,1,4,1,,5
11719,klumme-sludder,4,1,,1,4,1,,5
11720,https://t.co/PIUyfXmbnr,4,1,,1,4,1,,5
11721,bivirkning,1,0,,1,1,0,,1
11722,Somalia,16,10,,1,16,10,,26
11723,hjemtagelse,16,10,,1,16,10,,26
11724,somalier,16,10,,1,16,10,,26
11725,GrønGenstart,2,1,,1,2,1,,3
11726,president,60,36,,1,60,36,,96
11727,Jinping,60,36,,1,60,36,,96
11728,once,60,36,,1,60,36,,96
11729,promote,60,36,,1,60,36,,96
11730,trade,60,36,,1,60,36,,96
11731,both,60,36,,1,60,36,,96
11732,party,60,36,,1,60,36,,96
11733,https://t.co/vPx3dwD143,60,36,,1,60,36,,96
11734,Cepos,15,2,,1,15,2,,17
11735,Vismænd,15,2,,1,15,2,,17
11736,CO2-afgifter,15,2,,1,15,2,,17
11737,https://t.co/k6FI9Q5XmC,15,2,,1,15,2,,17
11738,taxameterbesparelse,0,1,,1,0,1,,1
11739,flybranchen,0,0,,1,0,0,,0
11740,Vist,16,3,,1,16,3,,19
11741,bestemme,7,3,,2,4,2,,10
11742,ekstremist,2,0,,1,2,0,,2
11743,Ærø,6,0,,1,6,0,,6
11744,Vanvittigt,0,0,,1,0,0,,0
11745,uambitiøst,0,0,,1,0,0,,0
11746,https://t.co/MWVFExa7Le,0,0,,1,0,0,,0
11747,medunderskriver,6,1,,1,6,1,,7
11748,int,6,1,,1,6,1,,7
11749,Haag,6,1,,1,6,1,,7
11750,Sundhedsmyndighederne,7,0,,1,7,0,,7
11751,EU–topmøde,63,21,,1,63,21,,84
11752,styrkegrænserne,63,21,,1,63,21,,84
11753,smugler,63,21,,1,63,21,,84
11754,forretningsmodel,63,21,,1,63,21,,84
11755,afrikaner,63,21,,1,63,21,,84
11756,euco,63,21,,1,63,21,,84
11757,Skovlandbrug,15,2,,1,15,2,,17
11758,foregangslandmænd,15,2,,1,15,2,,17
11759,animalsk,15,2,,1,15,2,,17
11760,Bedre,15,2,,1,15,2,,17
11761,udviklingsmiddel,15,2,,1,15,2,,17
11762,https://t.co/nexDQPu9yh,15,2,,1,15,2,,17
11763,Animation,30,8,,1,30,8,,38
11764,Workshop,30,8,,1,30,8,,38
11765,Wilbek,30,8,,1,30,8,,38
11766,https://t.co/ejfv4BJubW,8,0,,1,8,0,,8
11767,first,125,29,,1,125,29,,154
11768,British,125,29,,1,125,29,,154
11769,White,125,29,,1,125,29,,154
11770,Paper,125,29,,1,125,29,,154
11771,paper,125,29,,1,125,29,,154
11772,constructive,125,29,,1,125,29,,154
11773,eyes,125,29,,1,125,29,,154
11774,rights,207,54,,3,69,18,,261
11775,https://t.co/FdyK1DQ0WS,125,29,,1,125,29,,154
11776,politi-specialenheder,29,5,,1,29,5,,34
11777,politireformen,29,5,,1,29,5,,34
11778,genfremsættelse,29,5,,1,29,5,,34
11779,https://t.co/zSKTBPU3EP,29,5,,1,29,5,,34
11780,Tech-aflytninger,8,1,,1,8,1,,9
11781,krænke,8,1,,1,8,1,,9
11782,Panda-byggeriet,82,22,,1,82,22,,104
11783,ZOO,82,22,,1,82,22,,104
11784,Sun,82,22,,1,82,22,,104
11785,Xing,82,22,,1,82,22,,104
11786,flot,82,22,,1,82,22,,104
11787,anlæg,82,22,,1,82,22,,104
11788,yin,82,22,,1,82,22,,104
11789,yang,82,22,,1,82,22,,104
11790,https://t.co/v656sFSrf1,82,22,,1,82,22,,104
11791,LidtForHurtigPåTasterne,4,1,,1,4,1,,5
11792,https://t.co/No86OqyNGn,4,1,,1,4,1,,5
11793,Hus,5,1,,1,5,1,,6
11794,udtale,5,1,,1,5,1,,6
11795,kulturministerium,5,1,,1,5,1,,6
11796,Pios,5,1,,1,5,1,,6
11797,oplysninge,5,1,,1,5,1,,6
11798,Ord,20,3,,1,20,3,,23
11799,Kald,2,0,,1,2,0,,2
11800,norsk,42,6,,1,42,6,,48
11801,turist,42,6,,1,42,6,,48
11802,vask,42,6,,1,42,6,,48
11803,nedre,10,2,,1,10,2,,12
11804,https://t.co/LwaDK9GiHk,10,2,,1,10,2,,12
11805,delaftale,12,2,,1,12,2,,14
11806,videreførsel,12,2,,1,12,2,,14
11807,kompensationsordninger,12,2,,1,12,2,,14
11808,udvide,12,2,,1,12,2,,14
11809,https://t.co/EZTfx8D8WN,12,2,,1,12,2,,14
11810,https://t.co/fkbjXJNjzV,1,0,,1,1,0,,1
11811,embedsapparatet,1,0,,1,1,0,,1
11812,ordførerskab,152,1,,1,152,1,,153
11813,shariaråd,24,12,,1,24,12,,36
11814,byggeri,0,0,,1,0,0,,0
11815,Holbæk,0,1,,1,0,1,,1
11816,Kalundborg,0,1,,1,0,1,,1
11817,https://t.co/UKffpWkKEh,0,1,,1,0,1,,1
11818,udlændinge-området,3,2,,1,3,2,,5
11819,informationsminister,31,3,,1,31,3,,34
11820,Saddam,31,3,,1,31,3,,34
11821,Hussein,31,3,,1,31,3,,34
11822,komiskedan,31,3,,1,31,3,,34
11823,flygtningefamilie,13,3,,1,13,3,,16
11824,Test,12,4,,1,12,4,,16
11825,regerigen,12,4,,1,12,4,,16
11826,her.#dkpol,12,4,,1,12,4,,16
11827,https://t.co/fd7OBb9N6r,12,4,,1,12,4,,16
11828,verdensmålene,25,15,,1,25,15,,40
11829,Forandring,25,15,,1,25,15,,40
11830,https://t.co/aViiNyoa7v,25,15,,1,25,15,,40
11831,Kendetegnet,4,1,,1,4,1,,5
11832,felt,4,1,,1,4,1,,5
11833,morgensdagens,4,1,,1,4,1,,5
11834,egenrådig,4,1,,1,4,1,,5
11835,Valentin,0,0,,2,0,0,,0
11836,LOF,0,0,,1,0,0,,0
11837,https://t.co/3A4NjiWFpU,3,1,,1,3,1,,4
11838,⁦@regeringDK⁩,12,2,,1,12,2,,14
11839,dialogmøde,12,2,,1,12,2,,14
11840,Jow,12,2,,1,12,2,,14
11841,jow,12,2,,1,12,2,,14
11842,https://t.co/DtyyUM4CoD,12,2,,1,12,2,,14
11843,minibus,0,1,,1,0,1,,1
11844,dytte,0,1,,1,0,1,,1
11845,østjydenpåborgen,0,1,,1,0,1,,1
11846,randers,4,4,,2,2,2,,8
11847,https://t.co/80ybrFD29W,0,1,,1,0,1,,1
11848,Rejsebureauer,58,9,,1,58,9,,67
11849,messeleverandører,58,9,,1,58,9,,67
11850,taxavognmand,58,9,,1,58,9,,67
11851,busselskab,58,9,,1,58,9,,67
11852,hotelejer,58,9,,1,58,9,,67
11853,SMS,58,9,,1,58,9,,67
11854,nakke,24,3,,1,24,3,,27
11855,inkonsekvens,24,3,,1,24,3,,27
11856,Cars,0,0,,1,0,0,,0
11857,truck,0,0,,1,0,0,,0
11858,totally,23,33,,2,12,16,,56
11859,Therefore,0,0,,1,0,0,,0
11860,policy,0,0,,1,0,0,,0
11861,build,0,0,,1,0,0,,0
11862,roads,0,0,,1,0,0,,0
11863,opsving,23,5,,2,12,2,,28
11864,https://t.co/JHpHlgy92S,5,3,,1,5,3,,8
11865,Afgift,0,1,,1,0,1,,1
11866,transaktion,0,1,,1,0,1,,1
11867,finansieringskilde,0,1,,1,0,1,,1
11868,digitalisering,68,14,,1,68,14,,82
11869,Digital,68,14,,1,68,14,,82
11870,verdensklasse,68,14,,1,68,14,,82
11871,https://t.co/Eg2VfJoxsN,68,14,,1,68,14,,82
11872,https://t.co/UlOaiNsiYJ,68,14,,1,68,14,,82
11873,spand,2,1,,1,2,1,,3
11874,Psykiatritopmøde,16,1,,1,16,1,,17
11875,Stå,16,1,,1,16,1,,17
11876,https://t.co/B04ntxRaXz,16,1,,1,16,1,,17
11877,Addis,41,19,,1,41,19,,60
11878,Ababa,41,19,,1,41,19,,60
11879,globalgagrule,41,19,,1,41,19,,60
11880,dk4hrc,41,19,,1,41,19,,60
11881,https://t.co/EDFSdjkd86,41,19,,1,41,19,,60
11882,DEAs,0,0,,1,0,0,,0
11883,Sass',0,1,,1,0,1,,1
11884,klimaaflad,8,0,,1,8,0,,8
11885,https://t.co/a9neXRRYrt,8,0,,1,8,0,,8
11886,.@Digital_Agenda,5,3,,1,5,3,,8
11887,bredbåndsforum,5,3,,1,5,3,,8
11888,digitaltdk,5,3,,1,5,3,,8
11889,vejentilvækst,9,4,,3,3,1,,13
11890,mudder,7,0,,1,7,0,,7
11891,Djursland,0,1,,1,0,1,,1
11892,tropevarme,0,1,,1,0,1,,1
11893,besøge,0,1,,1,0,1,,1
11894,https://t.co/GDkHoanWtR,0,1,,1,0,1,,1
11895,Landet,18,5,,1,18,5,,23
11896,Beijing,18,5,,1,18,5,,23
11897,eksportfremstød,18,5,,1,18,5,,23
11898,https://t.co/PCiyRKpMJK,18,5,,1,18,5,,23
11899,PSO-regning,1,2,,1,1,2,,3
11900,FT-partier,1,2,,1,1,2,,3
11901,papirbøvl,10,1,,1,10,1,,11
11902,midte,46,5,,1,46,5,,51
11903,tidl.,46,5,,1,46,5,,51
11904,S-ledede,46,5,,1,46,5,,51
11905,Afstanden,5,2,,1,5,2,,7
11906,adskillelse,5,2,,1,5,2,,7
11907,https://t.co/OGbTYOjrop,5,2,,1,5,2,,7
11908,https://t.co/DknWxkFv0Q,15,1,,1,15,1,,16
11909,Nærhedsfond,19,3,,1,19,3,,22
11910,Sundhedsfællesskab,19,3,,1,19,3,,22
11911,Thy,19,3,,1,19,3,,22
11912,sikring,19,3,,1,19,3,,22
11913,akutfunktion,19,3,,1,19,3,,22
11914,https://t.co/77O5k7x8nr,19,3,,1,19,3,,22
11915,breakfast,60,27,,1,60,27,,87
11916,friends,60,27,,1,60,27,,87
11917,ALDE,60,27,,1,60,27,,87
11918,Strong,60,27,,1,60,27,,87
11919,law,60,27,,1,60,27,,87
11920,freedom,123,38,,2,62,19,,161
11921,Poland,60,27,,1,60,27,,87
11922,https://t.co/9ckcPLp83l,60,27,,1,60,27,,87
11923,ligestillingsdagsorden,57,16,,1,57,16,,73
11924,mangle,65,17,,2,32,8,,82
11925,minoritetsmiljøer,57,16,,1,57,16,,73
11926,æresbegreb,57,16,,1,57,16,,73
11927,ligestillling,57,16,,1,57,16,,73
11928,https://t.co/JgnUjP7YTp,57,16,,1,57,16,,73
11929,grill,14,0,,1,14,0,,14
11930,Mokaï,14,0,,1,14,0,,14
11931,ViSkalPåGrillen,14,0,,1,14,0,,14
11932,COP24,8,3,,1,8,3,,11
11933,hee,8,3,,1,8,3,,11
11934,https://t.co/pB8oWoI8Pc,8,3,,1,8,3,,11
11935,FL14,0,0,,1,0,0,,0
11936,implementering,2,4,,2,1,2,,6
11937,brud,0,0,,1,0,0,,0
11938,RUT,0,0,,1,0,0,,0
11939,veteran,54,20,,2,27,10,,74
11940,terrorbekæmpelsen,3,6,,1,3,6,,9
11941,kampagneteam,0,0,,1,0,0,,0
11942,facade,0,0,,1,0,0,,0
11943,https://t.co/XCdpWdjpL1,34,7,,1,34,7,,41
11944,fisketegn,6,0,,1,6,0,,6
11945,another,97,7,,1,97,7,,104
11946,note,97,7,,1,97,7,,104
11947,dåse,97,7,,1,97,7,,104
11948,retorisk,0,0,,1,0,0,,0
11949,Petersens,178,16,,1,178,16,,194
11950,Fluerne,4,0,,1,4,0,,4
11951,bestand,4,0,,1,4,0,,4
11952,MENA,6,6,,1,6,6,,12
11953,https://t.co/l8LfTrn19D,6,6,,1,6,6,,12
11954,topform,7,1,,1,7,1,,8
11955,neutral,4,0,,2,2,0,,4
11956,betydn,1,0,,1,1,0,,1
11957,Visionær,13,4,,1,13,4,,17
11958,pensionsløsning,13,4,,1,13,4,,17
11959,https://t.co/5xCYus6lxc,13,4,,1,13,4,,17
11960,kurv,7,0,,1,7,0,,7
11961,indkøbsvogn,7,0,,1,7,0,,7
11962,https://t.co/vuZwr5wX0u,72,10,,1,72,10,,82
11963,fortrolig,37,6,,2,18,3,,43
11964,forhandlingsforløb,1,0,,1,1,0,,1
11965,https://t.co/UMXyFDd64i,51,9,,1,51,9,,60
11966,Finansieringen,14,2,,1,14,2,,16
11967,ikke-eksisterende,14,2,,1,14,2,,16
11968,fvvalg,17,2,,1,17,2,,19
11969,https://t.co/adssas4s75,29,0,,1,29,0,,29
11970,krystalklar,175,8,,1,175,8,,183
11971,https://t.co/lPrCERQw1L»Vi-vil-ikke-være-med-i-en-aftale-hvor-du-starter-én-brand-for-at-slukke-en-anden,37,10,,1,37,10,,47
11972,https://t.co/PhknQBffnB,28,4,,1,28,4,,32
11973,konkurs,115,13,,2,58,6,,128
11974,beredskabsplan,27,7,,1,27,7,,34
11975,https://t.co/bsQWwRsUum,27,7,,1,27,7,,34
11976,fuppe,12,1,,1,12,1,,13
11977,https://t.co/0rQndHtR6k,12,1,,1,12,1,,13
11978,Hundige,9,0,,1,9,0,,9
11979,S-borgmestrene,56,9,,1,56,9,,65
11980,data,56,9,,1,56,9,,65
11981,udligningssystem,56,9,,1,56,9,,65
11982,partihoppere,6,0,,1,6,0,,6
11983,Ordentlige,1,0,,1,1,0,,1
11984,revolution,8,0,,1,8,0,,8
11985,https://t.co/ZKJOdo8Hdv,61,7,,1,61,7,,68
11986,detailstyre,7,2,,1,7,2,,9
11987,energiaftale,17,16,,1,17,16,,33
11988,PSO-afskaffelsen,6,4,,1,6,4,,10
11989,farvelPSO,6,4,,1,6,4,,10
11990,goddag,6,4,,1,6,4,,10
11991,https://t.co/nmEBUHdMgA,6,4,,1,6,4,,10
11992,Nilen,5,0,,1,5,0,,5
11993,kampagneleder,5,0,,1,5,0,,5
11994,Værs,168,3,,1,168,3,,171
11995,Arajuuri,17,1,,1,17,1,,18
11996,kvase,17,1,,1,17,1,,18
11997,hovedstødsduel,17,1,,1,17,1,,18
11998,POKALFINALE,17,1,,1,17,1,,18
11999,brøndby,33,2,,4,8,0,,35
12000,Århus,0,0,,1,0,0,,0
12001,TILLYKKE,5,0,,1,5,0,,5
12002,hollandsk,5,0,,1,5,0,,5
12003,medlemsskab,4,0,,1,4,0,,4
12004,IDA,4,0,,1,4,0,,4
12005,skatteminister,1,0,,1,1,0,,1
12006,Velstanden,0,0,,1,0,0,,0
12007,Fremgang,0,0,,1,0,0,,0
12008,flæng,0,0,,1,0,0,,0
12009,kommunistisk,0,0,,1,0,0,,0
12010,Cuba,7,0,,2,4,0,,7
12011,DDR,0,0,,1,0,0,,0
12012,https://t.co/k0EmrhCuAG,0,0,,1,0,0,,0
12013,begejstre,0,0,,1,0,0,,0
12014,taxa,1,0,,1,1,0,,1
12015,kontraktforhold,1,0,,1,1,0,,1
12016,millionbonus,69,19,,1,69,19,,88
12017,https://t.co/yS2Vlj7RSd,69,19,,1,69,19,,88
12018,sexchikane,5,2,,1,5,2,,7
12019,godtgørelse,5,2,,1,5,2,,7
12020,ligebehandlingsloven,5,2,,1,5,2,,7
12021,https://t.co/SBHirYXLb1,5,2,,1,5,2,,7
12022,segment,12,0,,1,12,0,,12
12023,THANK,22,6,,1,22,6,,28
12024,YOU,22,6,,1,22,6,,28
12025,stepping,22,6,,1,22,6,,28
12026,deforestation,22,6,,1,22,6,,28
12027,degradation,22,6,,1,22,6,,28
12028,https://t.co/HfLlZfho0n,22,6,,1,22,6,,28
12029,called,22,6,,1,22,6,,28
12030,Looking,32,7,,2,16,4,,39
12031,forward,32,7,,2,16,4,,39
12032,communication,22,6,,1,22,6,,28
12033,https://t.co/x1mav7flZq,22,6,,1,22,6,,28
12034,skaffe,2,0,,1,2,0,,2
12035,loeftebrud,2,0,,1,2,0,,2
12036,AT-analysen,2,2,,1,2,2,,4
12037,PSO-løsning,2,2,,1,2,2,,4
12038,https://t.co/PdxZSXjpaZ,2,2,,1,2,2,,4
12039,Nytårskur,13,3,,2,6,2,,16
12040,Hedensted,0,1,,1,0,1,,1
12041,http://t.co/Nyi7Tkg6fe,0,1,,1,0,1,,1
12042,banehalvdel,11,1,,1,11,1,,12
12043,Integrationstopmødet,12,4,,1,12,4,,16
12044,Beskæftigelse,12,4,,1,12,4,,16
12045,indvandrekvinder,12,4,,1,12,4,,16
12046,https://t.co/UiiA5V4yF4,12,4,,1,12,4,,16
12047,klogere?#dkpol,88,11,,1,88,11,,99
12048,SAS-reklame,14,0,,1,14,0,,14
12049,vælge,14,0,,1,14,0,,14
12050,flyselskab,14,0,,1,14,0,,14
12051,reklamefilm,14,0,,1,14,0,,14
12052,faguddannet,0,4,,1,0,4,,4
12053,jobfokus,0,4,,1,0,4,,4
12054,️Jeg,25,8,,1,25,8,,33
12055,Sundhedsmin,25,8,,1,25,8,,33
12056,Kvarte,1,0,,1,1,0,,1
12057,gisning,1,0,,1,1,0,,1
12058,https://t.co/rrxYFZqYu3,4,3,,1,4,3,,7
12059,Sydeuropa,20,1,,1,20,1,,21
12060,https://t.co/PRinQygErP,20,1,,1,20,1,,21
12061,host,10,1,,1,10,1,,11
12062,WomenDeliver19,10,1,,1,10,1,,11
12063,Congrats,10,1,,1,10,1,,11
12064,our,10,1,,1,10,1,,11
12065,follow,10,1,,1,10,1,,11
12066,gennemhulle,7,1,,1,7,1,,8
12067,mht.,30,4,,1,30,4,,34
12068,dækningskrav,0,0,,1,0,0,,0
12069,dækning,0,0,,1,0,0,,0
12070,JAAAAAAAAA,2,0,,1,2,0,,2
12071,.@Trinebramsen,0,1,,1,0,1,,1
12072,spørgetid,0,1,,1,0,1,,1
12073,Rabalderstræde,276,9,,1,276,9,,285
12074,https://t.co/dYgGhk06H1,276,9,,1,276,9,,285
12075,energiaftalen,3,0,,1,3,0,,3
12076,fremstilling,18,4,,2,9,2,,22
12077,mygeneration,3,0,,1,3,0,,3
12078,Sundhedsminister,77,1,,1,77,1,,78
12079,tyvstarte,0,0,,1,0,0,,0
12080,nødløgn,2,1,,1,2,1,,3
12081,http://t.co/AMazWmxuan,2,1,,1,2,1,,3
12082,fartgrænse,9,1,,1,9,1,,10
12083,lyskurv,9,1,,1,9,1,,10
12084,kælder,14,1,,1,14,1,,15
12085,trøje,14,1,,1,14,1,,15
12086,https://t.co/u42E1NNGYK,14,1,,1,14,1,,15
12087,skræmmekampagne,15,4,,1,15,4,,19
12088,https://t.co/LQzOrWa07l,15,4,,1,15,4,,19
12089,embedsmandsstillinger,3,0,,1,3,0,,3
12090,Vissevasse,33,1,,1,33,1,,34
12091,chokolade,33,1,,1,33,1,,34
12092,Pinlig,13,2,,1,13,2,,15
12093,rød-blok,13,2,,1,13,2,,15
12094,mediestunt,13,2,,1,13,2,,15
12095,boligbeskatningssystem,5,4,,1,5,4,,9
12096,nye12minutter,10,1,,1,10,1,,11
12097,https://t.co/P6NB4EIntf,10,1,,1,10,1,,11
12098,https://t.co/j9iwF6ePTo,24,1,,1,24,1,,25
12099,.@nvillumsen,1,2,,1,1,2,,3
12100,smagsdommer,1,2,,1,1,2,,3
12101,ydmyghed,5,0,,1,5,0,,5
12102,Stocklund,6,0,,2,3,0,,6
12103,Barbara,3,0,,1,3,0,,3
12104,Bertelsen,3,0,,1,3,0,,3
12105,svingdør,3,0,,1,3,0,,3
12106,satsp,6,4,,1,6,4,,10
12107,prioritet,6,4,,1,6,4,,10
12108,forebygge,6,4,,1,6,4,,10
12109,center,6,4,,1,6,4,,10
12110,pårør,6,4,,1,6,4,,10
12111,Arnold,88,6,,1,88,6,,94
12112,Busck,88,6,,1,88,6,,94
12113,SAS,88,6,,1,88,6,,94
12114,Skandinavien,88,6,,1,88,6,,94
12115,udbetale,88,6,,1,88,6,,94
12116,Macron,4,1,,1,4,1,,5
12117,merci,4,1,,1,4,1,,5
12118,køl,20,5,,1,20,5,,25
12119,https://t.co/vzl23QGNYl,20,5,,1,20,5,,25
12120,Air,23,33,,1,23,33,,56
12121,aid,23,33,,1,23,33,,56
12122,convoy,23,33,,1,23,33,,56
12123,Syria,46,66,,2,23,33,,112
12124,despicable,23,33,,1,23,33,,56
12125,Government,23,33,,1,23,33,,56
12126,immediately,23,33,,1,23,33,,56
12127,https://t.co/RGATVBhidA,31,7,,1,31,7,,38
12128,-og,35,11,,1,35,11,,46
12129,GGWcup,35,11,,1,35,11,,46
12130,UNGA73,35,11,,1,35,11,,46
12131,https://t.co/zZ8gINuxG0,35,11,,1,35,11,,46
12132,Rindahl,17,0,,1,17,0,,17
12133,high-five,17,0,,1,17,0,,17
12134,Kørekortet,17,0,,1,17,0,,17
12135,id-bevis,17,0,,1,17,0,,17
12136,ombæring,17,0,,1,17,0,,17
12137,sundhedskort,17,0,,1,17,0,,17
12138,hilsen,17,0,,1,17,0,,17
12139,https://t.co/T0qVV9l6mF,17,0,,1,17,0,,17
12140,smagløs,16,0,,1,16,0,,16
12141,konstruktiv,6,1,,2,3,0,,7
12142,Knuth,0,0,,1,0,0,,0
12143,konfirmation,0,0,,1,0,0,,0
12144,transportpolitisk,16,4,,1,16,4,,20
12145,https://t.co/ZOFuN6LNJJ,16,4,,1,16,4,,20
12146,skovfond,14,4,,1,14,4,,18
12147,Donér,14,4,,1,14,4,,18
12148,MobilePay,14,4,,1,14,4,,18
12149,https://t.co/9UpyE2969l,14,4,,1,14,4,,18
12150,HÃ¥ndvÃ,1,1,,1,1,1,,2
12151,rksfag,1,1,,1,1,1,,2
12152,https://t.co/eg3PA7E0kk,1,1,,1,1,1,,2
12153,erhvervsfaglig,1,1,,1,1,1,,2
12154,udskoling,1,1,,1,1,1,,2
12155,prostitution,2,0,,1,2,0,,2
12156,audiens,12,9,,1,12,9,,21
12157,Pave,12,9,,1,12,9,,21
12158,Frans,12,9,,1,12,9,,21
12159,Vatikanet,12,9,,1,12,9,,21
12160,Obama,29,0,,2,14,0,,29
12161,Bush,22,0,,1,22,0,,22
12162,Vågn,1,1,,1,1,1,,2
12163,https://t.co/6jmkeV9f3Z,1,1,,1,1,1,,2
12164,Polish,126,22,,2,63,11,,148
12165,government,63,11,,1,63,11,,74
12166,Corona-virus,63,11,,1,63,11,,74
12167,reduce,63,11,,1,63,11,,74
12168,EUpol,63,11,,1,63,11,,74
12169,SolidarityWithPolishWomen,63,11,,1,63,11,,74
12170,https://t.co/A6xlXJkujE,125,7,,1,125,7,,132
12171,JOK,2,1,,1,2,1,,3
12172,40’erne,2,1,,1,2,1,,3
12173,gyldig,2,1,,1,2,1,,3
12174,ivrig,2,1,,1,2,1,,3
12175,sjæl,2,1,,1,2,1,,3
12176,Fordyrende,15,2,,1,15,2,,17
12177,Forringer,15,2,,1,15,2,,17
12178,stik,15,2,,1,15,2,,17
12179,Kommunalreformen,15,2,,1,15,2,,17
12180,Internettet,6,0,,1,6,0,,6
12181,Farligt,155,9,,1,155,9,,164
12182,Nyheden,0,0,,1,0,0,,0
12183,nej-hatten,0,0,,1,0,0,,0
12184,sygeplejesker,0,0,,1,0,0,,0
12185,https://t.co/DXCTJKyLt2,16,3,,1,16,3,,19
12186,80erme,0,1,,1,0,1,,1
12187,utrovædighed,0,1,,1,0,1,,1
12188,escaperoom,11,0,,1,11,0,,11
12189,event,11,0,,1,11,0,,11
12190,Østerbro,11,0,,1,11,0,,11
12191,MEGA,11,0,,1,11,0,,11
12192,redverden,11,0,,1,11,0,,11
12193,befrier,11,0,,1,11,0,,11
12194,anciennitet,87,17,,1,87,17,,104
12195,jobskabelse,92,22,,2,46,11,,114
12196,https://t.co/6GyvHpnGtn,87,17,,1,87,17,,104
12197,konstatering,0,2,,1,0,2,,2
12198,https://t.co/UZpugHi3B6,32,15,,1,32,15,,47
12199,https://t.co/NrfHvHQ50e,32,15,,1,32,15,,47
12200,beskyldning,16,2,,1,16,2,,18
12201,sommerhus-branchen,62,5,,1,62,5,,67
12202,sommerhusejerne,62,5,,1,62,5,,67
12203,tysker,62,5,,1,62,5,,67
12204,13.,62,5,,1,62,5,,67
12205,Genforeningen,62,5,,1,62,5,,67
12206,EU-lovgivn,2,4,,1,2,4,,6
12207,MEP'ere,0,0,,1,0,0,,0
12208,indbygge,0,0,,1,0,0,,0
12209,TYS,0,0,,1,0,0,,0
12210,skattesmæk,31,7,,1,31,7,,38
12211,fordækt,31,7,,1,31,7,,38
12212,dobbeltspil,31,7,,1,31,7,,38
12213,Tilliden,31,7,,1,31,7,,38
12214,Larsens,76,14,,1,76,14,,90
12215,Charlotte,76,14,,1,76,14,,90
12216,Ahm,76,14,,1,76,14,,90
12217,https://t.co/iPnehpTKQB,76,14,,1,76,14,,90
12218,socialpolitik,3,1,,1,3,1,,4
12219,https://t.co/3O1Bv5vitc,3,1,,1,3,1,,4
12220,boligjobordningen,4,3,,1,4,3,,7
12221,fejlagtig,114,8,,1,114,8,,122
12222,Bankpakkerne,114,8,,1,114,8,,122
12223,veltilrettelagt,114,8,,1,114,8,,122
12224,https://t.co/pfjwCOF0MU,114,8,,1,114,8,,122
12225,Kamp,82,11,,2,41,6,,93
12226,grønl,1,6,,1,1,6,,7
12227,Fornuft,1,6,,1,1,6,,7
12228,honor,247,20,,1,247,20,,267
12229,American,247,20,,1,247,20,,267
12230,hero,247,20,,1,247,20,,267
12231,lost,247,20,,1,247,20,,267
12232,today,284,37,,2,142,18,,321
12233,RIPJohnMcCain,247,20,,1,247,20,,267
12234,miss,247,20,,1,247,20,,267
12235,https://t.co/eEgIcU45Qx,247,20,,1,247,20,,267
12236,Mink-formand,14,2,,1,14,2,,16
12237,https://t.co/BeOBzBPx8c,14,2,,1,14,2,,16
12238,afgiftsfritagelse,0,0,,1,0,0,,0
12239,Elbiler,0,0,,1,0,0,,0
12240,skulderklap,10,2,,1,10,2,,12
12241,mangeårig,35,4,,2,18,2,,39
12242,aktivistiske,10,2,,1,10,2,,12
12243,supermagt,10,2,,1,10,2,,12
12244,mane,1,0,,1,1,0,,1
12245,eftertanke,1,0,,1,1,0,,1
12246,skattemodel,4,0,,1,4,0,,4
12247,nøglemedarbejder,4,0,,1,4,0,,4
12248,IroniKanForekomme,4,0,,1,4,0,,4
12249,debattør,65,1,,1,65,1,,66
12250,anskuelse,65,1,,1,65,1,,66
12251,-det,3,0,,1,3,0,,3
12252,diversiteten,3,0,,1,3,0,,3
12253,præference,3,0,,1,3,0,,3
12254,patientansvarlige,5,0,,1,5,0,,5
12255,p4fyn,11,4,,2,6,2,,15
12256,mitfyn,13,5,,3,4,2,,18
12257,tv2fyn,12,4,,3,4,1,,16
12258,https://t.co/8CYGiP5ZBs,5,0,,1,5,0,,5
12259,Efterlønreformen,5,5,,1,5,5,,10
12260,krisehåndtering,5,5,,1,5,5,,10
12261,https://t.co/L5oWJ2hPRB,6,2,,1,6,2,,8
12262,fri-eller,14,1,,1,14,1,,15
12263,familie.,14,1,,1,14,1,,15
12264,TV2Fyn,1,0,,1,1,0,,1
12265,udlændinge-,1,0,,1,1,0,,1
12266,Fynpol,1,0,,1,1,0,,1
12267,http://t.co/HPThIfssqW,1,0,,1,1,0,,1
12268,Mettes,25,4,,1,25,4,,29
12269,koordinationsudvalg,25,4,,1,25,4,,29
12270,https://t.co/6kqNzf5BUv,25,4,,1,25,4,,29
12271,https://t.co/RjkNHLWvGS,1,1,,1,1,1,,2
12272,Not,1,0,,1,1,0,,1
12273,family,1,0,,1,1,0,,1
12274,mat,1,0,,1,1,0,,1
12275,parliaments,1,0,,1,1,0,,1
12276,Kræftskandalen,2,2,,1,2,2,,4
12277,Sjælland,2,2,,1,2,2,,4
12278,politiransagninger,2,2,,1,2,2,,4
12279,sigtelse,2,2,,1,2,2,,4
12280,latterlig,4,0,,1,4,0,,4
12281,USAs,4,0,,1,4,0,,4
12282,1:1,12,2,,2,6,1,,14
12283,70'erne,6,4,,1,6,4,,10
12284,DR-pausefilm,6,4,,1,6,4,,10
12285,filmomterner,6,4,,1,6,4,,10
12286,applaus,15,1,,1,15,1,,16
12287,https://t.co/LdjCcPkLBA,15,1,,1,15,1,,16
12288,Rome,37,17,,1,37,17,,54
12289,announcing,37,17,,1,37,17,,54
12290,contribution,37,17,,1,37,17,,54
12291,USD,37,17,,1,37,17,,54
12292,fund,37,17,,1,37,17,,54
12293,dedicated,37,17,,1,37,17,,54
12294,ways,37,17,,1,37,17,,54
12295,advancing,37,17,,1,37,17,,54
12296,women,37,17,,1,37,17,,54
12297,girls,37,17,,1,37,17,,54
12298,sexual,37,17,,1,37,17,,54
12299,emergencies,37,17,,1,37,17,,54
12300,WFP,37,17,,1,37,17,,54
12301,https://t.co/I5UQyK3dtM,37,17,,1,37,17,,54
12302,klimanæse,44,9,,1,44,9,,53
12303,https://t.co/zoIRiMeesJ,44,9,,1,44,9,,53
12304,åbningsplan,41,4,,1,41,4,,45
12305,fitness,41,4,,1,41,4,,45
12306,dans,41,4,,1,41,4,,45
12307,kulturdanmark,41,4,,1,41,4,,45
12308,genstart,41,4,,1,41,4,,45
12309,skærsild,29,0,,1,29,0,,29
12310,Kop,29,0,,1,29,0,,29
12311,Kande,29,0,,1,29,0,,29
12312,Hundigecentret,29,0,,1,29,0,,29
12313,december,29,0,,1,29,0,,29
12314,Landsmøde,0,0,,1,0,0,,0
12315,Programmet,7,1,,1,7,1,,8
12316,andendagen,7,1,,1,7,1,,8
12317,ICPD25,7,1,,1,7,1,,8
12318,NairobiSummit,7,1,,1,7,1,,8
12319,parlamentariker,7,1,,1,7,1,,8
12320,https://t.co/WTb0mzOqw4,7,1,,1,7,1,,8
12321,papir-clips,0,0,,1,0,0,,0
12322,:-)),0,0,,1,0,0,,0
12323,Udbudsgraden,0,0,,1,0,0,,0
12324,Reg,0,0,,1,0,0,,0
12325,mærkværdig,77,1,,1,77,1,,78
12326,V-regeringen,2,1,,1,2,1,,3
12327,forum,6,4,,1,6,4,,10
12328,COVID,6,4,,1,6,4,,10
12329,podcast,8,4,,2,4,2,,12
12330,ride,15,4,,2,8,2,,19
12331,pakkeafgift,15,4,,1,15,4,,19
12332,kvajebajer,42,19,,1,42,19,,61
12333,DRbyen,42,19,,1,42,19,,61
12334,Kenni,1,0,,1,1,0,,1
12335,Valgren,77,5,,1,77,5,,82
12336,triumf,77,5,,1,77,5,,82
12337,RESPEKT,77,5,,1,77,5,,82
12338,amstelgoldrace2018,77,5,,1,77,5,,82
12339,Hehehe,2,0,,1,2,0,,2
12340,touché,2,0,,1,2,0,,2
12341,globally,45,8,,1,45,8,,53
12342,colleague,45,8,,1,45,8,,53
12343,Kjer,45,8,,1,45,8,,53
12344,NYC,45,8,,1,45,8,,53
12345,leading,45,8,,1,45,8,,53
12346,impressive,45,8,,1,45,8,,53
12347,fighting,45,8,,1,45,8,,53
12348,ambitious,45,8,,1,45,8,,53
12349,CSW63,45,8,,1,45,8,,53
12350,everywhere,45,8,,1,45,8,,53
12351,DKatCSW63,45,8,,1,45,8,,53
12352,SRHR,45,8,,1,45,8,,53
12353,sdg5,45,8,,1,45,8,,53
12354,http://t.co/ivghDov5n8,2,1,,1,2,1,,3
12355,rettidigomhu,18,6,,1,18,6,,24
12356,samfundskagen,18,6,,1,18,6,,24
12357,Hmm,2,0,,1,2,0,,2
12358,Langeskov,2,1,,1,2,1,,3
12359,nysgerrighed,4,0,,1,4,0,,4
12360,tremme,0,0,,1,0,0,,0
12361,Piiiinligt,1,1,,1,1,1,,2
12362,FOA,4,2,,2,2,1,,6
12363,detektor,1,1,,1,1,1,,2
12364,https://t.co/N3HUxfZAe8,1,1,,1,1,1,,2
12365,ENIG,1,1,,1,1,1,,2
12366,Speciel,51,2,,1,51,2,,53
12367,togtur,51,2,,1,51,2,,53
12368,https://t.co/57wEhMZgXT,51,2,,1,51,2,,53
12369,blanding,0,0,,1,0,0,,0
12370,erhvervsarbejde,0,0,,1,0,0,,0
12371,erhvervsevne,0,0,,1,0,0,,0
12372,figurere,0,0,,1,0,0,,0
12373,pull-effekten,0,0,,1,0,0,,0
12374,udviklingsministre,92,22,,1,92,22,,114
12375,down,92,22,,1,92,22,,114
12376,memory,92,22,,1,92,22,,114
12377,lane,92,22,,1,92,22,,114
12378,https://t.co/umryZiz46d,92,22,,1,92,22,,114
12379,quizze,21,2,,1,21,2,,23
12380,https://t.co/XKJpjHsIH4,21,2,,1,21,2,,23
12381,snakke,13,1,,1,13,1,,14
12382,sååååå,13,1,,1,13,1,,14
12383,solskin,13,1,,1,13,1,,14
12384,https://t.co/prLNtAsMMu,13,1,,1,13,1,,14
12385,Sericeoplysning,0,0,,1,0,0,,0
12386,turismeerhvervene,8,2,,1,8,2,,10
12387,energivirksomheder,35,12,,2,18,6,,47
12388,herovre,13,6,,1,13,6,,19
12389,vækstpotentiale,13,6,,1,13,6,,19
12390,https://t.co/HnVUbvRGB7,13,6,,1,13,6,,19
12391,Klog,24,4,,1,24,4,,28
12392,https://t.co/ImVKv5CGbg,24,4,,1,24,4,,28
12393,hjertens,0,0,,1,0,0,,0
12394,dåd,0,0,,1,0,0,,0
12395,https://t.co/OuGRUyNxzg,18,3,,1,18,3,,21
12396,Trekløverregeringen,5,2,,1,5,2,,7
12397,Haugaard,1,0,,1,1,0,,1
12398,mellemst,1,0,,1,1,0,,1
12399,invalidepension,1,0,,1,1,0,,1
12400,alverd,7,4,,1,7,4,,11
12401,http://t.co/q6HJE5t8RP,7,4,,1,7,4,,11
12402,Kastrups,4,0,,1,4,0,,4
12403,spørgmål,4,0,,1,4,0,,4
12404,Frederiksens,171,19,,2,86,10,,190
12405,forbillede,156,16,,1,156,16,,172
12406,afgrund,156,16,,1,156,16,,172
12407,Brud,156,16,,1,156,16,,172
12408,Trads,12,0,,1,12,0,,12
12409,flippe,12,0,,1,12,0,,12
12410,foreningsdanmark,26,2,,1,26,2,,28
12411,karakterkravet,3,0,,1,3,0,,3
12412,ruste,202,28,,1,202,28,,230
12413,privatøkonomi,202,28,,1,202,28,,230
12414,byrde,202,28,,1,202,28,,230
12415,vsh,202,28,,1,202,28,,230
12416,https://t.co/jpROF7sSeh,202,28,,1,202,28,,230
12417,CO2-kvotesystem,7,5,,1,7,5,,12
12418,armeringsjern,7,5,,1,7,5,,12
12419,https://t.co/g7FFWseC9,7,5,,1,7,5,,12
12420,polemik,8,0,,2,4,0,,8
12421,krumtap,4,0,,1,4,0,,4
12422,udlændingeudspil,4,0,,1,4,0,,4
12423,genopretning,2,3,,1,2,3,,5
12424,morgen:-,0,1,,1,0,1,,1
12425,pensionsreform,53,8,,1,53,8,,61
12426,https://t.co/BH4dYGSSjk,18,2,,1,18,2,,20
12427,https://t.co/aRseBgyEbe,18,2,,1,18,2,,20
12428,https://t.co/ET05E2rNh8,1,0,,1,1,0,,1
12429,forlig,43,5,,1,43,5,,48
12430,bordende,43,5,,1,43,5,,48
12431,Sydsudan,60,23,,1,60,23,,83
12432,NGO'er,60,23,,1,60,23,,83
12433,https://t.co/LiD7cRjGox,60,23,,1,60,23,,83
12434,Indrømmet,5,0,,1,5,0,,5
12435,ansvarsfri,5,0,,1,5,0,,5
12436,enkeltsag,5,0,,1,5,0,,5
12437,konsekv,3,3,,1,3,3,,6
12438,slør,3,3,,1,3,3,,6
12439,Sæføli,3,3,,1,3,3,,6
12440,You,2,2,,1,2,2,,4
12441,ARE,2,2,,1,2,2,,4
12442,kidding,2,2,,1,2,2,,4
12443,Partiprogram,2,0,,1,2,0,,2
12444,senator,22,6,,1,22,6,,28
12445,Kongressen,22,6,,1,22,6,,28
12446,havvind,22,6,,1,22,6,,28
12447,https://t.co/TF4cV2pfJC,8,1,,1,8,1,,9
12448,ODENSE,8,1,,1,8,1,,9
12449,søge,16,2,,2,8,1,,18
12450,digtsamling,1,1,,1,1,1,,2
12451,https://t.co/CA172WsWum,21,10,,1,21,10,,31
12452,Stm,114,8,,1,114,8,,122
12453,4/5,39,0,,1,39,0,,39
12454,legitimitet,25,2,,1,25,2,,27
12455,uforholdsmæssig,25,2,,1,25,2,,27
12456,autokorrektur,30,1,,1,30,1,,31
12457,Elgiganten,31,0,,1,31,0,,31
12458,Jyllands-Posten,18,0,,1,18,0,,18
12459,Frederiksborg,1,0,,1,1,0,,1
12460,Amts,1,0,,1,1,0,,1
12461,sundhedsudspil,37,7,,1,37,7,,44
12462,HELE,37,7,,1,37,7,,44
12463,nærhedsreform,37,7,,1,37,7,,44
12464,scorereplik,6,2,,1,6,2,,8
12465,håndjern,6,2,,1,6,2,,8
12466,klaskbagi,6,2,,1,6,2,,8
12467,kommunalreform,15,3,,1,15,3,,18
12468,bizar,15,3,,1,15,3,,18
12469,sundhedsområde,0,1,,1,0,1,,1
12470,hvadvilS,0,1,,1,0,1,,1
12471,S-ordføreren,41,9,,1,41,9,,50
12472,Sanders,18,0,,2,9,0,,18
12473,less,9,0,,1,9,0,,9
12474,win,9,0,,1,9,0,,9
12475,cleare,9,0,,1,9,0,,9
12476,union,9,0,,1,9,0,,9
12477,Nevada,9,0,,1,9,0,,9
12478,Tuesday,9,0,,1,9,0,,9
12479,Game,9,0,,1,9,0,,9
12480,train,9,0,,1,9,0,,9
12481,unstoppable,9,0,,1,9,0,,9
12482,udokumenterede,11,1,,1,11,1,,12
12483,bredbånd,4,1,,2,2,0,,5
12484,dkibalance,1,0,,1,1,0,,1
12485,Erling,13,5,,1,13,5,,18
12486,Bonnesen,13,5,,1,13,5,,18
12487,sejrskurs,13,5,,1,13,5,,18
12488,gågade,13,5,,1,13,5,,18
12489,https://t.co/9cbaOWIEsi,13,5,,1,13,5,,18
12490,https://t.co/dbIyC0aBmM,30,4,,1,30,4,,34
12491,Assentoft,3,2,,1,3,2,,5
12492,pjece,3,2,,1,3,2,,5
12493,østjysk,3,2,,1,3,2,,5
12494,teamaastrup,3,2,,1,3,2,,5
12495,https://t.co/nu44JUF6CC,3,2,,1,3,2,,5
12496,ulejlighed,6,0,,1,6,0,,6
12497,knt.hjælp,0,0,,1,0,0,,0
12498,grænseåbning,0,0,,1,0,0,,0
12499,sundhedshedsministeren,1,1,,1,1,1,,2
12500,energiafgift,5,5,,1,5,5,,10
12501,https://t.co/Xt6h3l7bpL,6,6,,1,6,6,,12
12502,års-kriteriet,3,1,,1,3,1,,4
12503,https://t.co/XYxOQl17hF,47,10,,1,47,10,,57
12504,uretfærdighed,2,0,,1,2,0,,2
12505,https://t.co/icTJcqYv8N,2,0,,1,2,0,,2
12506,Sony,23,0,,1,23,0,,23
12507,Walkman,23,0,,1,23,0,,23
12508,kassettebånd,23,0,,1,23,0,,23
12509,Nordjyllands,6,4,,1,6,4,,10
12510,halvvejs,7,0,,1,7,0,,7
12511,+20,1,0,,1,1,0,,1
12512,varsel,2,0,,1,2,0,,2
12513,centre,4,1,,1,4,1,,5
12514,nedtrykt,17,2,,1,17,2,,19
12515,mansplaine,17,2,,1,17,2,,19
12516,Høhø,17,2,,1,17,2,,19
12517,kommunekasse,0,0,,1,0,0,,0
12518,LASSE,6,0,,1,6,0,,6
12519,VIGEN,6,0,,1,6,0,,6
12520,Sldk,6,0,,1,6,0,,6
12521,https://t.co/kG98Pc2LvB,6,0,,1,6,0,,6
12522,Gammel,1,0,,1,1,0,,1
12523,Kongevej,1,0,,1,1,0,,1
12524,Olesen,0,1,,1,0,1,,1
12525,Erhvervsuddannede,5,1,,1,5,1,,6
12526,mangelvare,5,1,,1,5,1,,6
12527,Mike,5,1,,1,5,1,,6
12528,Starup,5,1,,1,5,1,,6
12529,BillundOnline,5,1,,1,5,1,,6
12530,PSO-afgiften,0,0,,1,0,0,,0
12531,el-priser,0,0,,1,0,0,,0
12532,Tjaa,0,0,,1,0,0,,0
12533,Putins,10,1,,1,10,1,,11
12534,optimist,10,1,,1,10,1,,11
12535,ager,10,1,,1,10,1,,11
12536,borgmestermøde,0,0,,1,0,0,,0
12537,Forståeligt,0,0,,1,0,0,,0
12538,varig,0,5,,1,0,5,,5
12539,Midt-,0,5,,1,0,5,,5
12540,ethanol,0,5,,1,0,5,,5
12541,https://t.co/sjv5OuRePx,0,5,,1,0,5,,5
12542,https://t.co/uPlf2T9N86,5,3,,1,5,3,,8
12543,venskabelighed,2,1,,1,2,1,,3
12544,fusk,2,1,,1,2,1,,3
12545,Tobenet,2,0,,1,2,0,,2
12546,nobel-prismodtageren,81,2,,1,81,2,,83
12547,årsfest,81,2,,1,81,2,,83
12548,https://t.co/CRtikd2V4E,81,2,,1,81,2,,83
12549,skatteforhøjelse,0,0,,1,0,0,,0
12550,Italienske,0,0,,1,0,0,,0
12551,Frandsen,13,2,,1,13,2,,15
12552,foreningskultur,13,2,,1,13,2,,15
12553,genforening,13,2,,1,13,2,,15
12554,Rød,14,8,,1,14,8,,22
12555,bekende,14,8,,1,14,8,,22
12556,kulør,14,8,,1,14,8,,22
12557,https://t.co/VeNcsiv54q,14,8,,1,14,8,,22
12558,teleminister,5,4,,1,5,4,,9
12559,megabit,5,4,,1,5,4,,9
12560,tredoble,5,4,,1,5,4,,9
12561,https://t.co/iG2QF6EFPC,5,4,,1,5,4,,9
12562,Dorte,1,0,,1,1,0,,1
12563,https://t.co/8JgnhbJQWe,3,1,,1,3,1,,4
12564,kok,21,1,,1,21,1,,22
12565,aktie,8,2,,1,8,2,,10
12566,smagsdommeri,81,5,,1,81,5,,86
12567,Montricepigernes,81,5,,1,81,5,,86
12568,dæleme,81,5,,1,81,5,,86
12569,våge,2,0,,1,2,0,,2
12570,Champignon,1,0,,1,1,0,,1
12571,Butiksassistenten,24,5,,1,24,5,,29
12572,tjener,24,5,,1,24,5,,29
12573,rengøringsasistenten,24,5,,1,24,5,,29
12574,foreningsidrætten,48,5,,1,48,5,,53
12575,https://t.co/UONXBI5K9u,48,5,,1,48,5,,53
12576,Personlighed,0,0,,1,0,0,,0
12577,modsvar,4,1,,1,4,1,,5
12578,Vestens,4,1,,1,4,1,,5
12579,https://t.co/bhsBKdZzcp,4,1,,1,4,1,,5
12580,sundhedvæsnet,35,8,,1,35,8,,43
12581,https://t.co/ULorTA9bqf,35,8,,1,35,8,,43
12582,butiksejer,105,1,,1,105,1,,106
12583,pokal,27,1,,1,27,1,,28
12584,Samfundssind,1,2,,1,1,2,,3
12585,snævertsynet,1,2,,1,1,2,,3
12586,udansk,1,2,,1,1,2,,3
12587,https://t.co/73EHaJKqyb,1,2,,1,1,2,,3
12588,Dybvad,7,12,,1,7,12,,19
12589,hov,2,1,,1,2,1,,3
12590,børnehave,2,1,,1,2,1,,3
12591,Borgmesterkontoret,1,0,,1,1,0,,1
12592,Læsø,1,0,,1,1,0,,1
12593,designermøbler,1,0,,1,1,0,,1
12594,rådhus,1,0,,1,1,0,,1
12595,bakke,4,2,,1,4,2,,6
12596,snarlig,4,2,,1,4,2,,6
12597,civilsamfundsarrangementer,4,2,,1,4,2,,6
12598,https://t.co/vPJFdKgU1x,4,2,,1,4,2,,6
12599,https://t.co/Eiupb7F8uv,5,8,,1,5,8,,13
12600,Kontanthjælp,2,2,,1,2,2,,4
12601,Juhu-politik,2,2,,1,2,2,,4
12602,randområde,3,1,,1,3,1,,4
12603,udlændingelempelser,8,7,,1,8,7,,15
12604,delordførerskaber,2,1,,1,2,1,,3
12605,https://t.co/Ju1lcCuAsW,2,1,,1,2,1,,3
12606,Morgenfrisk!!@venstre,10,1,,1,10,1,,11
12607,https://t.co/aXF2wok7B5,10,1,,1,10,1,,11
12608,https://t.co/NxbmHkpFWe,140,22,,1,140,22,,162
12609,regeringsudgivelse,0,0,,1,0,0,,0
12610,2025-plan,0,0,,1,0,0,,0
12611,ung.udd,20,9,,1,20,9,,29
12612,Vild,8,1,,1,8,1,,9
12613,halvleg,8,1,,1,8,1,,9
12614,Jobbe,8,1,,1,8,1,,9
12615,brandkamp,8,1,,1,8,1,,9
12616,offensiv,8,1,,1,8,1,,9
12617,Strukturelle,1,1,,1,1,1,,2
12618,detailregulering,1,1,,1,1,1,,2
12619,IWD2015,1,1,,1,1,1,,2
12620,http://t.co/l7FdqJLHEK,1,1,,1,1,1,,2
12621,Fortryder,60,11,,1,60,11,,71
12622,tæv,60,11,,1,60,11,,71
12623,luck,60,11,,1,60,11,,71
12624,halal-hippier,60,11,,1,60,11,,71
12625,World,31,17,,1,31,17,,48
12626,Council,31,17,,1,31,17,,48
12627,kåre,31,17,,1,31,17,,48
12628,Administration,27,10,,1,27,10,,37
12629,https://t.co/qno0aHolLu,27,10,,1,27,10,,37
12630,Ældretopmøde,6,2,,1,6,2,,8
12631,Sundhedsudspillet,0,0,,1,0,0,,0
12632,låne,10,1,,1,10,1,,11
12633,Kunst,18,7,,1,18,7,,25
12634,mode,18,7,,1,18,7,,25
12635,Henning,18,7,,1,18,7,,25
12636,https://t.co/0IQbjNJbLJ,18,7,,1,18,7,,25
12637,https://t.co/RjFgqB1vB3,36,6,,1,36,6,,42
12638,blotte,39,7,,1,39,7,,46
12639,Hænger,39,7,,1,39,7,,46
12640,analysere,1,0,,1,1,0,,1
12641,dirigent,2,0,,1,2,0,,2
12642,landsstævne,2,0,,1,2,0,,2
12643,pølsemix,2,0,,1,2,0,,2
12644,udgiftstop,1,2,,1,1,2,,3
12645,Fr.,1,2,,1,1,2,,3
12646,voldtægtsmand,5,1,,1,5,1,,6
12647,selvkritik,0,0,,1,0,0,,0
